&c.	etc.
'Ban	Caliban
'Hio	Ohio
'I'm	I'm
'Melia's	Amelia's
'Merrica	America
'Od's	God's
'a	he
'a's	he's
'ackney-coach	hackney-coach
'ackney-coachman	hackney-coachman
'ad	had
'airs	hairs'
'and	and
'ave	have
'bacca	tobacco'
'baht	about
'balmed	embalmed
'bide	abide
'bides	abides
'blest	blest
'blige	oblige
'bliged	obliged
'bout	about
'bove	above
'bserver	observer
'bused	abused
'cagion	occasion
'casion	occasion
'cause	because
'cerns	concerns
'cide	decide
'climating	acclimating
'clined	inclined
'commend	recommend
'commodate	accommodate
'cordin'	according
'count	account
'counts	accounts
'cross	across
'cute	acute
'cuteness	acuteness
'd	would
'deed	indeed
'dention	attention
'dizening	bedizening
'dst	wouldst
'ealth	health
'ealthiest	healthiest
'ear	year
'ears	years
'eart	heart
'ee	thee
'em	them
'em's	em's
'er	her
'ere	here
'faith	faith
'feard	afeard
'fended	offended
'fess	confess
'for	before
'fore	before
'forehand	beforehand
'fraid	afraid
'gad	egad
'gainst	against
'gan	began
'gin	begin
'gins	begins
'gree	agree
'greed	agreed
'greeing	agreeing
'hind	behind
'ike	ike
'ild	yield
'lack	alack
'laith	laith
'larum	alarm
'larum-bell	alarm-bell
'larums	alarms
'leges	alleges
'listed	enlisted
'live	alive
'll	will
'long	along
'longed	belonged
'longeth	belongs
'longing	belonging
'longs	belongs
'longside	alongside
'loo	halloo
'magine	imagine
'markably	remarkably
'marks	remarks
'mazin'	amazing
'member	remember
'mid	amid
'mong	among
'mongst	among
'n	him
'natomy	anatomy
'nointed	anointed
'normously	enormously
'nother	another
'oman	woman
'oman's	woman's
'only	only
'oon	own
'orld	world
'orth	worth
'our	our
'parel	apparel
'parison	comparison
'pear	appear
'pears	appears
'pent	repent
'pinion	opinion
'pless	bless
'point	appoint
'point'st	appointest
'pointed	appointed
'pointing	appointing
'pon	upon
'portant	important
'prentice	prentice
'prentice-boys	apprentice-boys'
'prentice-house	prentice-house
'prenticed	apprenticed
'prenticehouse	prentice-house
'prentices	apprentices
'printice	prentice
'printice-master	prentice-master
'printiced	prenticed
'quired	acquired
'quirin'	inquiring
'r	are
're	are
'rested	arrested
'rests	arrests
'rived	arrived
'rizon	horizon
'save	save
'sayed	assayed
'schew	eschew
'scuse	excuse
'scuses	excuses
'seris'	serious
'shrew	beshrew
'sistency's	consistency's
'sizes	assizes
'special	special
'specially	especially
'spectable	respectable
'spectations	expectations
'spected	expected
'spectful	respectful
'spectin'	expecting
'spects	expects
'spite	despite
'spitefully	spitefully
'sponsibility	responsibility
'spose	suppose
'st	hast
'stead	instead
'stonished	astonished
'stroyed	destroyed
't	it
'tall	t'all
'tame	attame
'tan't	'tisn't
'teak	steak
'ticed	enticed
'tide	betide
'till	until
'tis	it's
'tish	'tis
'top	stop
'torney	attorney
'ts	its
'tween	between
'twill	it'll
'twixt	betwixt
'ud	would
'ull	will
'un	one
'uns	ones
'up	up
'vantage	advantage
've	have
'vise	advise
'voided	avoided
'ware	aware
'way	away
'world	world
2d.	twopence
6d.	sixpence
ADAM	Adam
ADDISON	Addison
ADRIANO	Adriano
AEacida	Aeacida
AEacides	Aeacides
AEneas	Aeneas
AEneas'	Aeneas'
AEolus	Aeolus
AEsculapius	Aesculapius
AEson	Aeson
AEsop	Aesop
AEtna	Aetna
AFFGHANISTAN	Afghanistan
AGUECHEEK	Aguecheek
AHAB	Ahab
AHAB'S	Ahab's
AMANTIUM	Amantium
AMELIA	Amelia
ANDREW	Andrew
ARMADA	Armada
ARMADO	Armado
ARMSTRONG	Armstrong
ARSACIDES	Arsacides
ARTEMIDORUS	Artemidorus
ARTHUR'S	Arthur's
AUGUSTUS	Augustus
AW	I
AZORE	Azore
Abbén	Abbé
Achilles's	Achilles'
Adon	Adonis
Adons	Adonis
Ajax'	Ajax's
Al'ce	Alice
Alisander	Alexander
Amamon	Amaimon
Anglish	English
Anglo-Saxon	Anglo-Saxon
Ariachne's	Ariadne's
Aw'd	I'd
Aw'll	I'll
Aw'm	I'm
Aw's	I'se
Aws	I'm
Ay'll	I'll
BECKY	Becky
BEECHER	Beecher
BELFAST	Belfast
BENTLEY	Bentley
BERTRAM	Bertram
BOSTON	Boston
BRIGHTON	Brighton
BRIT	Brit
BROTHERTON	Brotherton
BRUSSELS	Brussels
BRYANT	Bryant
BUTE	Bute
Balthasar	Balthazar
Barthol'mew	Bartholomew
Ben-Lawers	Ben-lawers
Bermoothes	Bermudas
Black-Friars	Blackfriars
Bourdeaux	Bordeaux
Briggs's	Briggs'
Brit-Ish	British
Brute	Brutus
CANNY	Canny
CAPILET	Capilet
CASSY	Cassy
CHATHAM	Chatham
CHE	I
CHESNEY	Chesney
CHINA	China
CHISWICK	Chiswick
CLARISSA	Clarissa
CLEVELAND	Cleveland
COLEMAN	Coleman
CONAN	Conan
CRAWLEY	Crawley
CRAWLEY'S	Crawley's
CUFF'S	Cuff's
Cacaliban	Caliban
Cadwallader	Cadwalader
Capels	Capulets
Capels'	Capulets'
Charing-cross	Charingcross
Charles's	Charles'
Cheshu	Jesu
Chrish	Christ
Christen	Christian
Christom	Christian
Christophero	Christopher
Circes	Circe's
Clarence'	Clarence's
Clelias	Clelia's
Color-Serjeant	Color-serjeant
Crahnr's'	Crahnr's
Cressid's	Cressida's
Cressids	Cressidas
DAGGOO	Daggoo
DAYVLE	Dayvle
DEDLOCK	Dedlock
DERBYSHIRE	Derbyshire
DIANA	Diana
DICK	Dick
DINAH	Dinah
DOBBIN	Dobbin
DOWLING	Dowling
DOWLINGS	Dowlings
Deep-Valley	Deep-valley
Dian's	Diana's
Diomed's	Diomedes'
Dough-Boy's	Dough-boy's
Dut	Dutch
ECCL	Eccl
ECUADOR	Ecuador
EDGAR	Edgar
ELIZA	Eliza
ELIZA'S	Eliza's
ELLERY	Ellery
EMMELINE	Emmeline
ENDERBY	Enderby
ENGLAND	England
ENNERDALE	Ennerdale
EOTHEN	Eothen
ESQ	Esq
ESTHER'S	Esther's
EVA	Eva
EVA'S	Eva's
EVANGELINE	Evangeline
EZEKIEL	Ezekiel
Edinbro'	Edinborough
Embro'	Embro
Ercles	Hercules
Ercles'	Hercules'
Ethiope	Ethiop
Ethiope's	Ethiop's
Ethiopes	Ethiops'
FALSTAFF	Falstaff
FEDALLAH	Fedallah
FLASK	Flask
GABBERLY	Gabberly
GAM	Gam
GASTON	Gaston
GEORGE	George
GEORGY	Georgy
GLEIG	Gleig
GONERIL	Goneril
GREENWOOD	Greenwood
GREGORY'S	Gregory's
Gay-Header's	Gay-header's
Geffrey	Geoffrey
Ger	Her'
Gis	Jesu
Goliases	Goliaths
Got's	God's
Grissel	Griselda
HAB	Hab
HALEY	Haley
HAMLET	Hamlet
HAMPSHIRE	Hampshire
HARDY	Hardy
HARRIET	Harriet
HARRIS	Harris
HAWTHORNE	Hawthorne
HEIDELBURGH	Heidelburg
HENRIQUE	Henrique
HENRY	Henry
HERMAN	Herman
HETTY'S	Hetty's
HOBART	Hobart
HYMEN	Hymen
Ha'rford-west	Hartford-west
Harris's	Harris'
Hibocrates	Hippocrates
Holy-rood	Holyrood
Horrocks's	Horrocks'
I'ld	I'd
I'n	I've
ICELAND	Iceland
ISABELLA	Isabella
ISHMAEL	Ishmael
Inch-Grabbit	Inch-grabbit
Isbel's	Isabel's
Isbels	Isabels
Iv'e	I've
JACK	Jack
JAGO'S	Jago's
JAMES	James
JARNDYCE	Jarndyce
JEMIMA	Jemima
JEROBOAM'S	Jeroboam's
JEWETT	Jewett
JO'S	Jo's
JOHN	John
JONAH	Jonah
JOS	Jos
JOSEPH	Joseph
Jack-a-Lent	Jack-a-lent
James's	James'
Jeshu	Jesu
Jesu	Jesus
Joseph's'	Joseph's
Jud-as	Judas
KENTUCK	Kentucky
KIT	Kit
Katharine's	Katherine's
Kentuck	Kentucky
Kintuck	Kentucky
KirkChrist	Kirkchrist
L've	I've
LASCAR	Lascar
LEONATUS	Leonatus
LINCOLNSHIRE	Lincolnshire
LISBETH	Lisbeth
LONDON	London
LONG-ISLAND	Long-Island
Laurence'	Laurence's
Lawrence	Laurence
Leo-natus	Leonatus
Lestrale	Lestrake
Leviathan	Levia
Lick-the-Ladle	Lick-the-ladle
Lucrece'	Lucrece's
M'M	M'm
MAB	Mab
MACKENZIE	Mackenzie
MACY	Macy
MALL	Mall
MALTESE	Maltese
MALVOLIO	Malvolio
MANX	Manx
MAPPLE	Mapple
MARDI	Mardi
MARTHA	Martha
MARY	Mary
MATTHEW	Matthew
MELVILLE	Melville
MICHAEL	Michael
MICHAEL'S	Michael's
MOBY	Moby
MOBY-DICK	Moby-Dick
MONTAIGNE	Montaigne
MORRIS	Morris
Ma'mselle	Mademoiselle
Margar't	Margaret'
Methodies'	Methodists'
Methodisses	Methodists
Methody	Methodist
Methodys	Methodists
Moby-Dick	Moby-dick
Moyses	Moses
Mr	Mr.
Mrs	Mrs.
Muscovits	Muscovites
NANTUCKET	Nantucket
NATHAN	Nathan
NATHANIEL	Nathaniel
NELL	Nell
Native-Hindoo	native-Hindoo
O'D	O'd
OHIO	Ohio
OHPELIA'S	Ophelia's
OI	I
OLDHAM	Oldham
OMOO	Omoo
OPHELIA'S	Ophelia's
OSBORNE	Osborne
Oi'm	I'm
Oi'se	I'se
Oi've	I've
PAROLLES	Parolles
PARSONS	Parsons
PEHEE-NUEE-NUEE	Pehee-nuee-nuee
PEKEE-NUEE-NUEE	Pekee-nuee-nuee
PEQUOD	Pequod
PINKERTON	Pinkerton
PIP	Pip
PITT	Pitt
POSTHUMUS	Posthumus
POYSER	Poyser
PROCTER	Procter
Pabylon	Babylon
Pall-Mall	Pall-mall
Pandar's	Pandarus'
Peesel	Pistol
Pheezar	Caesar
Phenix	Phoenix
Phibbus'	Phœbus'
Philippe	Philip
Phoebus	Phœbus
Phoebus'	Phœbus'
Phyrnia	Phrynia
Polonius's	Polonius'
Prooshians	Prussians
Ptolemies'	Ptolemy's
Pyramus's	Pyramus'
QUAKER	Quaker
QUEENHOO-HALL	Queenhoo-hall
QUEEQUEG	Queequeg
QUITO	Quito
RACHEL	Rachel
RAMADAN	Ramadan
RAWDON	Rawdon
REBECCA	Rebecca
REBECCA'S	Rebecca's
REDBURN	Redburn
REPUBLICA	Republica
RHEIN	Rhein
RHYMER	Rhymer
RICHARD	Richard
ROBBINS	Robbins
ROBERT	Robert
ROSE-BUD	Rose-bud
Raggles's	Raggles'
Raine	Rain
Ravelations	Revelations'
Rooshians	Russians
Rosycrucians	Rosicrucians
Rubricks	Rubric
SAMUEL	Samuel
SCOTT	Scott
SEDLEY	Sedley
SETH	Seth
SHELBY	Shelby
SMALLWEED	Smallweed
SNAGSBY	Snagsby
SPHYNX	Sphynx
STARBUCK	Starbuck
STEYNE	Steyne
STOWE	Stowe
STRUTT'S	Strutt's
STUBB	Stubb
STUBB'S	Stubb's
SUNDAY	Sunday
Salique	Salic
Sandie	Sandy
Sept	September
Shafalus	Cephalus
Sharpe	Sharp
Shaven	Shaved
Sturgis's	Sturgis'
Sugarplums'	Sugarplums
Syenna's	Sienna's
Sylla	Sulla
Syracusa	Syracyse
TALBOT	Talbot
TASHTEGO	Tashtego
THOMAS	Thomas
TOM	Tom
TOM-ALL-ALONE'S	Tom-all-alone's
TOPSY	Topsy
TOWN-HO'S	Town-ho's
TREMLETT	Tremlett
TULKINGHORN'S	Tulkinghorn's
TYPEE	Typee
Tavy's	Davy's
Thisby	Thisbe
Thisby's	Thisbe's
Thisne	Thisbe
Tom-all-Alone's	Tom-all-alone's
Town-Ho's	Town-ho's
Treddles'on	Treddleston
Troyan	Trojan
VAUXHALL	Vauxhall
Veroles	Verolles
Vitus's	Vitus'
WALTER	Walter
WAVERLEY	Waverley
WESTMORLAND	Westmorland
WHITE-JACKET	White-jacket
WILLIAM	William
WILLIS	Willis
WORTHINGTON	Worthington
Waverley-Chace	Waverley-Chace
Waverley-Honour	Waverley-honour
White-Friars	Whitefriars
White-Jacket	White-jacket
Wiclif's	Wicliffe's
YORK	York
Yedward	Edward
a'getten	got
a'lee	alee
a'low	alow
a'mighty's	almighty's
a'most	almost
a'n't	aren't
a'nodding	nodding
a'nt	isn't
a'ready	already
a'shiver	ashiver
a't	hast
a'top	atop
a-bakin'	baking
a-balancing	balancing
a-batfowling	batfowling
a-be	be
a-bed	abed
a-begging	begging
a-billing	billing
a-bin	been
a-birding	birding
a-bleatin'i'	bleating
a-breeding	breeding
a-brewing	brewing
a-bringin'	bringing
a-capering	capering
a-carrying	carrying
a-chasing	chasing
a-cold	cold
a-comin'	coming
a-coming	coming
a-cryin'	crying
a-crying	crying
a-cursing	cursing
a-doin	doing
a-doing	doing
a-doting	doting
a-down	down
a-down-a	down
a-dressing	dressing
a-driving	driving
a-dropping	dropping
a-ducking	ducking
a-dyin'	dying
a-dying	dying
a-feasting	feasting
a-findin'	finding
a-finding	finding
a-giving	giving
a-goin'	going
a-going	going
a-groaning	groaning
a-growing	growing
a-hanging	hanging
a-height	height
a-high	high
a-hold	ahold
a-hooting	hooting
a-hungry	hungry
a-killing	killing
a-kissing	kissing
a-laughing	laughing
a-longing	longing
a-lookin'	looking
a-lyin'	lying
a-makin'	making
a-making	making
a-many	many
a-marr'in'	marrying
a-marr'ing	marrying
a-mekin'	making
a-mending	mending
a-missing	missing
a-piece	apiece
a-pieces	a-apiece
a-plaguin'	plaguing
a-prayin'	praying
a-praying	praying
a-preachin'	preaching
a-preaching	preaching
a-repairing	repairing
a-restin'	resting
a-ripening	ripening
a-rolling	rolling
a-scouring	scouring
a-scratching	scratching
a-sewing	sewing
a-shaking	shaking
a-shouting	shouting
a-singin'	singing
a-sittin'	sitting
a-sitting	sitting
a-sleepin'	sleeping
a-sleeping	sleeping
a-smilin'	smiling
a-snatching	snatching
a-sparklin'	sparkling
a-standing	standing
a-starin'	staring
a-staring	staring
a-starn	astern
a-strapping	strapping
a-swearing	swearing
a-talking	talking
a-telling	telling
a-thievin'	thieving
a-thinking	thinking
a-trembling	trembling
a-trying	trying
a-turnin'	turning
a-usin'	using
a-visitin'	visiting
a-walking	walking
a-watering	watering
a-weeping	weeping
a-whaling	whaling
a-wooing	wooing
a-workin'	working
aEdiles	aediles
aEgle	aegle
abaht	about
abbominable	abominable
abhominable	abominable
abhorredst	abhorredest
ableeding	bleeding
aboot	about
abound'st	aboundest
abrook	brook
abt	about
accompt	account
accordeth	accords
accordin'	according
accountant-General	accountant-general
accountedst	accountedest
accoutred	accoutered
accurs'd	accursed
accurst	accursed
accuseth	accuses
achin'	aching
acquintance	acquaintance
acquit	acquitted
acrost	across
addeth	adds
adieux	adieus
adolescence'	adolescence's
adoreth	adores
adown	down
adown-a	down
advanc'd	advanced
ae	a
afeared	afeard
aff	off
affaires	affairs
affecteth	affects
affeered	afeard
affordeth	affords
afsd	aforesaid
aft'noon	afternoon
aften	often
after-dinner's	afterdinner's
after-times	aftertimes
after-wards	afterwards
afterward	afterwards
ag'in	again
again'	against
againe	again
agazed	gazed
ageyn	against
aggravatin'	aggravating
aggravatinest	aggravatingest
aggriefed	aggrieved
aght	ought
agin'	against
agoin'	going
agoing	going
agone	ago
agonie	agony
agoo	ago
agwine	going
ah!	ah
aha!	aha
ahr	our
aht	out
aides-de-Camp	aides-de-camp
aim'st	aimest
ain	own
ain't	aren't
airley	early
aitch	each
al	all
al'ays	always
al'us	always
alane	alone
alarum	alarm
alarum-bell	alarm-bell
alarumed	alarmed
alarums	alarms
ale-house	alehouse
ale-houses	alehouses
ale-wife	alewife
alehouse'	ale-house's
all'us	always
all-Seer	all-seer
all-hallond	all-hallow
all-hallown	all-hallow
all-thing	al-thing
all-worthy	allworthy
allarms	alarms
allas	always
allicholy	melancholy
allus	always
almanack	almanac
almanacks	almanacs
almanecks	almanacs
alooan	alone
aloon	alone
altho'	although
alway	always
alwayth	always
amaist	almost
amang	among
amazeth	amazes
amazin'	amazing
amen!	amen
amende	amend
amidst	amid
amone	among
amost	almost
an'	and
an-hungry	hungry
anacondas	anaconda
ance	once
ancient'st	ancientest
ancle	ankle
and't	an't
and-a	and
ane	one
aneuch	enough
angerly	angrily
anglo-Saxon	Anglo-Saxon
ankers	anchors
anoo	enough
anoof	enough
ans	once
answer'st	answerest
anti-Cinder	anti-cinder
anythink	anything
anyways	anyway
anywhar	anywhere
anywheres	anywhere
anywhers	anywheres
apaid	paid
apologise	apologize
apostraphas	apostrophes
apparelled	appareled
appartements	apartments
appear'd	appeared
appeareth	appears
apple-tart	appletart
apple-trees	appletrees
approacheth	approaches
approv'd	approved
apricocks	apricots
aqua-vitae	aquavitae
aqueducs	aqueducts
ar'n't	aren't
ar's	there's
araneides	araneids
arbors	arbours
arcadian	Arcadian
arch-enemy	archenemy
aready	already
ariseth	arises
arm'd	armed
arm-and-arm	arm-in-arm
armadoes	armadas
armie	army
arn't	aren't
arnt	earned
arraign'd	arraigned
arrow-root	arrowroot
arter	after
artes	arts
artilirie	artillery
artizans	artisans
artn't	aren't
artna	aren't
as'	as
as'es	as's
as'ull	as'll
asayin'	saying
ask'd	asked
ask'st	askest
askaunt	askance
asketh	asks
askin'	asking
asphalte	asphalt
aspicious	suspicious
assaileth	assails
assaye	assay
asse	as
assoilzied	assoiled
atchieved	achieved
athversary	adversary
atn't	aren't
attend'st	attendest
attendeth	attends
attened	attended
aud	and
auld	old
aunchient	ancient
auther	author
autor	author
auy	any
ave	have
avised	advised
awa	away
awaketh	awakes
awanting	wanting
aweary	weary
aweel	well
awk'ard	awkward
awn	own
awtered	altered
axed	asked
axle-tree	axletree
ay!	ay
ay-'arvest	hay-harvest
ayther	either
b'ar	bear
b'lieve	believe
back'	back
back'ard	backwards
back'ards	backwards
back'st	backest
back-friend	backfriend
back-gammon	backgammon
back-ground	background
bad'st	badst
baes	bahs
bag-piper	bagpiper
bah!'d	bah'd
baht	about
bakin'	baking
balck	black
baldrick	baldric
bamboo-Town	bamboo-town
banteing	bantering
bar'ls	barrels
bare	bore
bare-bone	barebone
bare-footed	barefooted
bare-headed	bareheaded
bark'st	barkest
barketh	barks
barne	bairn
barnes	barns
baron-Bailie	baron-bailie
barr'st	barrest
barthens	burdens
base-born	baseborn
battalia	battalions
battaliam	battalion
battalliam	battalion
bauld	bald
baulder	balder
baulk	balk
bawdy-house	bawdyhouse
baynt	aren't
be-lee'd	belee'd
be-met	bemet
be-mete	bemete
be-monster	bemonster
be-netted	benetted
be-tumbled	betumbled
beam'd	beamed
beameth	beams
bear'st	bearest
bear-Warden	bear-warden
bear-baiting	bearbaiting
bear-ward	bearward
bearard	bear-herd
beareth	bears
beau-ti-ful	beautiful
beccare	bacare
beck'ning	beckoning
bed-chamber	bedchamber
bed-clothes	bedclothes
bed-ridden	bedridden
bed-room	bedroom
bed-rumes	bedrooms
bed-time	bedtime
bedevilling	bedeviling
beean	began
beetle-headed	beetleheaded
beeves	beefs
befal	befall
befel	befell
beflumm'd	beflummed
before-named	beforenamed
before-time	beforetime
began'st	begannest
beget'st	begettest
begg'st	beggest
beginnin'	beginning
begot	begotten
beguilnig	beguiling
behavedst	behavedest
behind-hand	behindhand
behold'st	beholdest
behoved	behooved
bein'	being
bejewelled	bejeweled
belabored	belaboured
belanging	belonging
beldam	beldame
beldam's	beldame's
beldams	beldames
believeth	believes
bell-wether	bellwether
belles	bells
bellyfulls	bellyfuls
belubed	beloved
bended	bent
bendin'	bending
benumb'd	benumbed
bequeath	bequeathe
bereaved	bereft
berkeley-Square	berkeley-square
berrid	buried
berrin	burying
berry	very
berryin	burying
berrying	burying
bery	berry
beseech'	beseech
beseemeth	beseems
besides	beside
bespake	bespoke
bestead	besteaded
bestrode	bestrid
betideth	betides
betrayedst	betrayedest
betted	bet
betther	better
bettre	better
between-Brussels	between-brussels
between-whiles	betweenwhiles
betwigst	betwixt
bewidged	bewitched
bid'st	biddest
big-swoln	big-swollen
bigetun	begotten
bigitun	begotten
bilbow	elbow
bindeth	binds
binnaclewatch	binnacle
birth-day	birthday
birth-hour's	birth's
birth-right	birthright
bis'ness	business
bisness	business
biteth	bites
bitin'	biting
bivouacks	bivouacs
black'st	blackest
blacken'd	blackened
blazon'st	blazonest
bleed'st	bleedest
bleedeth	bleeds
bleedn	bleeding
blent	blinded
bless'd	blessed
blesseth	blesses
blessin'	blessing
blest	blessed
blood-hound	bloodhound
blood-sucker	bloodsucker
blood-suckers	bloodsuckers
blood-sucking	bloodsucking
blood-thirsty	bloodthirsty
bloody-sceptered	bloody-sceptred
blow'st	blowest
blue-bottle	bluebottle
bluid	blood
bluidy	bloody
blustrous	blusterous
bo'	about
bo-peep	bopeep
boath	both
bohemian-Tartar	bohemian-tartar
bold'st	boldest
bold-faced	boldfaced
boll'n	bollen
bond-slaves	bondslaves
bone-ache	boneache
booath	both
book-men	bookmen
booke	book
bookin'	booking
boot-hose	boothose
boozin'	boozing
bore	boar
borne	born
borrow'dst	borrowedest
bottle-Nose	bottle-nose
bouge	budge
boun'	bound
boundeth	bounds
boundin'	bounding
bow-string	bowstring
bow-strings	bowstrings
bowes	bows
braggards	braggarts
bran-new	brand-new
bravos	bravoes
brazen-face	brazenface
brazen-faced	brazenfaced
break'st	breakest
break-neck	breakneck
breaketh	breaks
breakin'	breaking
breatheth	breathes
bred'ren	brothers
bredren	brothers
breedeth	breeds
breff	brief
brethren	brothers
brethren's	brothers'
brew-house	brewhouse
brewin'	brewing
bribed-buck	bribe-bucked
brick-wall	brickwall
bride-bed	bridebed
bridle-bitts	bridle-bits
brieves	briefs
brigger	bigger
brigness	bigness
bring'st	bringest
bringeth	brings
bringin'	bringing
brocken	broken
brothe	broth
browt	brought
brusts	bursts
builded	built
buildeth	builds
bull-calf	bullcalf
bullyin'	bullying
bung-hole	bunghole
burneth	burns
burnin	burning
burnin'	burning
burnt	burned
burs	burrs
burthen	burden
burthened	burdened
burthens	burdens
buryin'	burying
busilest	busiest
busines	business
business'	business's
butler'd	butlered
buyin'	buying
by-gone	bygone
by-past	bypast
by-paths	bypaths
by-words	bywords
byegones	bygones
byoo-ootiful	beautiful
ca'	call
ca'd	called
cabine	cabin
cahnt	cannot
cailliachs	cailliaches
cajolled	cajoled
calculatin	calculating
call'd	called
call'st	callest
calledst	calledest
calleth	calls
callin'	calling
calves'-guts	calf-guts
can'le	candle
can'st	canst
cancelled	canceled
cancelling	canceling
candle-holder	candleholder
candle-light	candlelight
cankerblossom	canker-blossom
canna	cannot
cannut	cannot
cannót	cannot
canonize	canonise
canvass	canvas
canvassing	canvasing
cap'ain	captain
cap'n	captain
cap'n's	captain's
caperin'	capering
captain'd	captained
capting	captain
car'ge	carriage
car'less	careless
car's	carries
carack	carrack
caracks	carracks
carawans	caravans
carcass	carcase
carcasses	carcases
card-maker	cardmaker
card-table	cardtable
careth	cares
carieatures	caricatures
carle	carl
carles	carls
caroll'd	caroled
carolled	caroled
carolling	caroling
carpenterin'	carpentering
carryin'	carrying
carte	cart
cas'alty	casualty
cast-away	castaway
casted	cast
castedst	castedest
casteth	casts
castle-Building	castle-building
cat-a-mountain	catamountain
catchin'	catching
catechize	catechise
cathecism	catechism
cauf	calf
caus'd	caused
causeth	causes
cavaleiro	cavalero
cavalery	cavalero
cavalrie	cavalry
caverton-Edge	caverton-edge
caviare	caviar
cavilling	caviling
ceaseth	ceases
ceassed	ceased
center	centre
cesse	cease
chaces	chases
cham'er	chamber
chamber-councils	chamber-counsels
chambre	chamber
chap-fallen	chapfallen
chapellin'	chapeling
chapmen's	chapman's
chappellin'	chapeling
charg'd	charged
chargeth	charges
charmeth	charms
charnel-house	charnelhouse
charrit	chariot
chaseth	chases
chasin'	chasing
chasten'd	chastened
chasteneth	chastens
chat-Moss	chat-moss
chaunt	chant
check'd	checked
checkered	chequered
cheecks	cheeks
cheer'st	cheerest
cherry-stone	cherrystone
chid'st	chidest
chil'en	children
child-like	childlike
childe	child
childer	children
childre	children
chile's	child's
chimnies	chimneys
chirrah	sirrah
chiselled	chiseled
choaking	choking
chollors	cholers
chooseth	chooses
chops	chaps
chorusses	choruses
chosing	choosing
chozzen	chosen
christenin'	christening
christian	Christian
christmas-day	christmasday
church-Yard	church-yard
church-way	churchway
chuse	choose
chuses	chooses
chusing	choosing
cibil	civil
civil'st	civilest
clapper-claw	clapperclaw
clapper-de-claw	clapperclaw
clapt	clapped
clar	clear
clar't	claret
clarin'	declaring
cleanin'	cleaning
cleaved	cleft
clepeth	clepes
clept	cleped
clere	clear
clergy's	clergies'
clerk-like	clerklike
climbeth	climbs
clippeth	clips
cliverer	cleverer
cloised	closed
cloo'as	clothes
cloose	clothes
close-stool	closestool
closly	closely
cloths	clothes
cmotions	emotions
co-equal	coequal
co-heirs	coheirs
co-partners	copartners
coal-black	coalblack
coasteth	coasts
cocoa-Tree	cocoa-tree
coffee-House	coffee-house
coffin-colored	coffin-coloured
coflicting	conflicting
cogscomb	coxcomb
cold'st	coldest
cold-blooded	coldblooded
cold-hearted	coldhearted
collectin'	collecting
color	colour
colored	coloured
colors	colours
colour-Sergeants	colour-sergeants
com'd	came
com'st	comest
comboined	combined
come's	comes
comed	came
cometh	comes
comforteth	comforts
comin	coming
comin'	coming
command'st	commandest
commander-in-Chief	commander-in-chief
commed	came
commin	coming
commit'st	committest
common'st	commonest
common-place	commonplace
compasseth	compasses
complainin'	complaining
complements	compliments
compos'd	composed
compremises	compromises
compt	count
con-found	confound
concerneth	concerns
confesseth	confesses
confidantes	confidants
confidentia'	confidential
congied	congeed
conscience'	conscience's
considable	considerable
considerin	considering
considerin'	considering
consience	conscience
consisteth	consists
consort'st	consortest
constraineth	constrains
contemned'st	contemnedest
content-a	content
contenteth	contents
contrairies	contraries
contrairy	contrary
contrivedst	contrivedest
controule	control
conven'ent	convenient
cony-catching	conycatching
cook's-Courtiers	cook's-courtiers
cookin'	cooking
cookit	cooked
coom	come
coomin'	coming
coorted	courted
coortin'	courting
coorting	courting
corn-field	cornfield
coronetted	coroneted
corrivalled	corrivaled
corse	corpse
corses	corpses
cosey	cosy
cotch	catch
cotched	catched
cotchin'	catching
cou'd	could
coucheth	couches
could'st	couldst
could't	couldn't
could-na	couldn't
couldna	couldn't
council-board	councilboard
counselled	counseled
countcardinal	count-cardinal
counterfeit'st	counterfeitest
country-seat	countryseat
court-Guide	court-guide
court-gate	courtgate
courte	court
courtezan	courtesan
coustusmes	customs
covereth	covers
covert'st	covertest
cow-dung	cowdung
cowl-staff	cowlstaff
coystrill	coystril
crab-tree	crabtree
crab-trees	crabtrees
crackin	cracking
crackin'	cracking
cracklin'	crackling
craveth	craves
creatur	creature
creatur'	creature
creatur's	creature's
creaturs	creatures
creeped	crept
creetur	creature
crest-fallen	crestfallen
cretur	creature
cretur's	creature's
creturs	creatures
criedst	criedest
crieth	cries
critters	creatures
crittur	creature
crittur's	creature's
critturs	creatures
crook-knee'd	crook-kneed
cross-bow	crossbow
cross-bows	crossbows
cross-row	crossrow
crossin	crossing
crossin'	crossing
cruell'st	cruelest
crueller	crueler
cruellest	cruelest
crueltys	cruelty's
crusheth	crushes
cryin'	crying
cudgelled	cudgeled
cudgelling	cudgeling
cultivatin'	cultivating
cum	came
cunning'st	cunningest
cur'ous	curious
curi's	curious
curis	curious
curous	curious
cursed'st	cursedest
curst	cursed
curstest	cursedest
curtesie	courtesy
curtseys	curtsies
curvetted	curveted
curvetting	curveting
cussed	cursed
cussedest	cursedest
cussin'	cursing
custom-House	custom-house
cut-throat	cutthroat
cutt'st	cuttest
cuttin'	cutting
cuttit	cut
cvidently	evidently
cymballed	cymbaled
cyphers	ciphers
d'or	d'Or
d'rectly	directly
dahn	down
daht	that
dam'	damned
dam'n	damn
dame's	dam's
damm'st	dammest
damme	damn
damn'd	damned
damndest	damnedest
damned'st	damnedest
damp'd	damped
dan	than
dan-gerous	dangerous
danc'st	dancest
danceth	dances
dancin'	dancing
danglin'	dangling
danish	Danish
dar's	there's
dar'st	darest
daring'st	daringest
darken'd	darkened
darlin	darling
darn't	daren't
dat	that
dat's	that's
daugther	daughter
dauhter-in-law	daughter-in-law
dawg	dog
dawgs	dogs
dawnin'	dawning
day's-wark	day's-work
daz'd	dazed
dazzleth	dazzles
dear'st	dearest
dear-a	dear
dearn	dern
death's-bed	deathbed
death-like	deathlike
death-practised	death-practiced
debateth	debates
debel	devil
debil	devil
debitor	debtor
debuty	deputy
deceiveth	deceives
declar	declare
declin'd	declined
dee	thee
deep-mouthed	deepmouthed
deevil	devil
deevil's	devil's
defeat'st	defeatest
deformed'st	deformedest
deil	devil
deils	devils
deloighted	delighted
demeanor	demeanour
demi-Atlas	demi-atlas
demselves	themselves
demuring	demurring
denayed	denied
deniedst	deniedest
dention	attention
denyin'	denying
depart'st	departest
departed'st	departedest
dependance	dependence
der's	there's
dere	there
dere's	there's
desartless	desertless
desarvin'	deserving
descant'st	descantest
deserv'st	deservest
deservedst	deservedest
desp't	desperately
despatch	dispatch
despatched	dispatched
despiseth	despises
despit	desperately
dest'ny	destiny
destin'd	destined
det	debt
dev'lish	devilish
developes	develops
devil-Dam	devil-dam
devilled	deviled
deviseth	devises
devlish	devilish
devoureth	devours
devourigly	devouringly
dew-lapped	dewlapped
dewoted	devoted
dey'll	they'll
dich	do
dictatin'	dictating
did'nt	didn't
did'st	didst
didna	didn't
diedst	diedest
differency	difference
difficultie	difficulty
digged	dug
diggin'	digging
digt	digged
din't	didn't
ding-dong	dingdong
dinin'-room	dining-room
dinna	don't
dippedst	dippedest
dis	this
dis-stained	disstained
disburthened	disburdened
discern'st	discernest
disclaim'st	dischargest
discolored	discoloured
discourseth	discourses
disdain'st	disdainest
disdaineth	disdains
disembowelled	disemboweled
disgustiug	disgusting
dishevelled	disheveled
dishonor	dishonour
dishonored	dishonoured
dishonoring	dishonouring
disjoint	disjoined
dismall'st	dismallest
dismissd	dismissed
dispises	despises
disponge	dispunge
disputin'	disputing
distill	distil
distills	distils
distrubed	disturbed
divers	diverse
divers-coloured	diverse-coloured
divideth	divides
divil	devil
divil's	devil's
divvle's	devil's
dixonary	dictionary
do'e	do
do'n	don't
doat	dote
doated	doted
doating	doting
doatingly	dotingly
doats	dotes
docketted	docketed
doctorin'	doctoring
doesna	doesn't
doest	dost
doff'd	doffed
dog-hole	doghole
dog-like	doglike
doil'd	doiled
doin'	doing
doins	doings
don'no	don't
donkies	donkeys
donn'd	donned
donno	don't
donno'	don't
donnot	don't
dont	don't
doo's	does
dooant	don't
doom'd	doomed
dooms-day	doomsday
doon	done
doos	does
doosn't	doesn't
doteth	dotes
doth	does
doubt'st	doubtest
dough-Boy	dough-boy
doun	down
doune	down
dout	doubt
dove-cote	dovecote
dove-house	dovehouse
dowle	dowl
down-trod	downtrod
draggin'	dragging
draging	dragging
draw'st	drawest
draweth	draws
drawin'	drawing
dre'ful	dreadful
dreadeth	dreads
dreadin'	dreading
dream'st	dreamest
dreamt	dreamed
drefful	dreadful
dress'd	dressed
dressd	dressed
drest	dressed
drew'st	drewest
drily	dryly
drink'st	drinkest
drinketh	drinks
drinkin	drinking
drinkin'	drinking
driv	driven
driveth	drives
droopeth	droops
droppeth	drops
dropt	dropped
drowing	drowning
drownded	drowned
dry-foot	dryfoot
duchess'	duchess's
duelling	dueling
dulness	dullness
dun	don't
dun-coloured	dun-colored
dunno	don't
dunnot	don't
dunnut	don't
duodecimoes	duodecimos
dureing	during
durs'	dares
durst	dared
durstna	durstn't
dustn't	durstn't
dutch	Dutch
dwelleth	dwells
dwelt	dwelled
dwollers	dwellers
dy'e-call-'em	dy'e-call-'ems
dye	die
dyeing	dying
dyin'	dying
e'en	even
e'er	ever
e'er-remaining	ever-remaining
ear-wax	earwax
earnins	earnings
earth-bound	earthbound
easeth	eases
eated'st	eatedest
eatin	eating
eatin'	eating
eawr	our
eawt	out
eber	ever
ebrew	hebrew'
ech	each
eche	eke
echo'st	echoest
ecstacy	ecstasy
ee	thee
ee've	thee'd
egal	equal
egally	equally
egg-shell	eggshell
egg-shells	eggshells
egma	enigma
eh?	eh
eight-pences	eight-pence
eld	old
eld'st	oldest
eldest	oldest
elightened	enlightened
else's	else
em	them
embattailed	embattled
embowelled	emboweled
embowelling	emboweling
empale	impale
emperial	imperial
emperial's	imperial's
emply	employ
empress'	empress's
en-r-r-r-raged	enraged
enah	enough
enamelled	enameled
encloseth	encloses
encompasseth	encompasses
endeavoring	endeavouring
endeavors	endeavours
endured'st	enduredest
endureth	endures
eneugh	enough
enforced	inforced
enforces	inforces
enforcest	inforcest
enginer	engineer
engirt	engirded
english	English
engraffed	engrafted
engraft	engrafted
enjoineth	enjoins
enlargeth	enlarges
enoo	enough
enoo'	enough
enoof	enough
enought	enough
enow	enough
enpierced	empierced
enquire	inquire
enquired	inquired
enquiring	inquiring
enquiringly	inquiringly
ensnareth	ensnares
ensteeped	insteeped
entail'd	entailed
entent	intent
enter'd	entered
enterance	entrance
entereated	entreated
entertain'st	entertainest
enticeth	entices
entreated	intreated
equalled	equaled
equils	equals
escapedst	escapedest
escapend	escaped
essayeth	essays
esteem'st	esteemest
esteemeth	esteems
estridges	ostriches
ev'n	even
ev'ry	every
even-Christian	even-christian
evenin'	evening
evenue	avenue
ever-during	everduring
ever-living	everliving
evere	ever
everthing	everything
everythin'	everything
everythink	everything
everyways	everyway
everywhar	everywhere
everywheres	everywhere
exalteth	exalts
exceedeth	exceeds
excelleth	excels
exhorter	exhorte
exist'st	existest
expence	expense
expences	expenses
expresseth	expresses
extacy	ecstasy
extasies	ecstasies
extatic	ecstatic
extremitie	extremity
extro'rnary	extraordinary
extry	extra
ey	they
eye-brows	eyebrows
eye-lashes	eyelashes
eye-sore	eyesore
eye-strings	eyestrings
eying	eyeing
eyne	eyes
f'r	for
fa'r	fair
fa'rd	fared
fadeth	fades
faery	fairy
fagots	faggots
fahl	foul
fail'st	failest
failin'	failing
faint-hearted	fainthearted
fair'st	fairest
fairy-land	fairyland
faith-breach	faithbreach
faithfull'st	faithfullest
fall'n	fallen
fall'n-off	fallen-off
fall'st	fallest
falleth	falls
fallin	falling
fallin'	falling
falorous	valorous
false-hearted	falsehearted
falteing	faltering
fam'ly	family
famly	family
fardel	farthel
fardels	farthels
fardingales	farthingales
farm-house	farmhouse
fartuous	virtuous
fast'ned	fastened
fast-Fish	fast-fish
fastidions	fastidious
fat-Cutter	fat-cutter
fathur's	father's
faut's	fault's
favored	favoured
favorite	favourite
fawneth	fawns
fawther	father
fawther's	father's
fay	faith
fear'st	fearest
feard	feared
feareth	fears
fearfnlly	fearfully
fearfull'st	fearfullest
feather-bed	featherbed
fecks	faith
feed'st	feedest
feedeth	feeds
feel'st	feelest
feelin	feeling
feelin'	feeling
feelin's	feelings
fehemently	vehemently
feith	faith
fell'st	fellest
feller	fellow
feller's	fellow's
feller-niggers	fellow-negroes
fellers	fellows
fellow'st	fellowest
fellow-creatur's	fellow-creature's
fellow-creaturs	fellow-creatures
fellow-critters	fellow-creatures
felt'st	feltst
fendin'	fending
ferce	fierce
fery	very
fet	fetched
fetchin'	fetching
fetterin'	fettering
feyther	father
feyther's	father's
fidgetting	fidgeting
fidgetty	fidgety
field-Marshal	field-marshal
field-bed	fieldbed
fiend-like	fiendlike
fifty-pun'	fifty-pound
fight'st	fightest
fighteth	fights
fightin'	fighting
figurin'	figuring
filleth	fills
fillin'	filling
fillys	fillies
fin-Back	fin-back
fin-Back's	fin-back's
fin-Backs	fin-backs
find'st	findest
fingre	finger
fingres	fingers
firago	virago
fire-drake	firedrake
fire-side	fireside
firin'	firing
first-born	firstborn
first-fruits	firstfruits
fish-e	fish
fish-ponds	fishponds
fishermon	fisherman
fishes	fish
fisnomy	physiognomy
fitt'st	fittest
fitteth	fits
five-fold	fivefold
flame-colored	flame-coloured
flap-dragon	flapdragon
flap-jacks	flapjacks
flat-long	flatlong
flatter'st	flatterest
flavored	flavoured
fledgelings	fledglings
fledst	fleddest
fleet'st	fleetest
fler	fellow
fler'll	fellow'll
flieth	flies
floatin'	floating
flood-gate	floodgate
flood-gates	floodgates
flourisheth	flourishes
flourishin'	flourishing
fly-blown	flyblown
flyin'	flying
foamin'	foaming
focative	vocative
foetid	fetid
fole	fool
folks's	folks'
follerer's	follower's
follerers	followers
follow'st	followest
followedst	followedest
folly-fall'n	folly-fallen
foolin	fooling
foolin'	fooling
foot-path	footpath
for'ard	forward
forard	forward
forards	forward
forbad	forbade
forbod	forbad
forborne	forborn
fore-foot	forefoot
fore-going	forgoing
fore-knowledge	foreknowledge
fore-past	forepast
fore-recited	forerecited
fore-thinking	forthinking
forego	forgo
foregoing	forgoing
foregone	forgone
foretel	foretell
forget'st	forgettest
forgetteth	forgets
forgettin'	forgetting
forgi'	forgive
forgi'e	forgive
forgie	forgive
forgiv	forgive
forgoers	foregoers
forgot	forgotten
form'd	formed
forrads	foreheads
forrard	forward
forrenner	foreigner
forsaketh	forsakes
fortni't	fortnight
fortune-teller	fortuneteller
forwards	forward
forwearied	forewearied
fosset-seller	fossett-seller
foster-brethren	foster-brothers
fought'st	foughtest
foul'st	foulest
foul-mouthed	foulmouthed
foul-mouthed'st	foul-mouthedest
fould	fouled
foulks	folks
found'st	foundest
four-in-Hand	four-in-hand
fra	from
fra'	from
frae	from
frail'st	frailest
free-Mason	free-mason
free-hearted	freehearted
freend	friend
french	French
fresh-water	freshwater
fretten	fretted
frettin'	fretting
frever	forever
frolickin'	frolicking
froo	from
froo'	from
frough	from
frown'st	frownest
fructful	fruitful
frutify	fructify
fu'	full
fule's	fool's
fules	fools
full-grown	fullgrown
fulness	fullness
furder	further
furriners	foreigners
furrow'd	furrowed
fussin'	fussing
futher	further
g'uttons	gluttons
gal	girl
gal's	girl's
gallant'st	gallantest
gallopped	galloped
gallopping	galloping
gallowses	gallows
gals	girls
gambolling	gamboling
gar'd	garred
gardon	guerdon
gat	got
gather'd	gathered
gathereth	gathers
gaun	gone
gawded	gauded
gawds	gauds
gay-Head	gay-head
gazeth	gazes
gell	girl
gells	girls
gelt	gelded
gen	gened
gen'ally	generally
gen'l	general
gen'l'man	gentleman
gen'lly	generally
gen'lman's	gentleman's
gen'lmen	gentlemen
gen'ly	generally
geniùs	genius
genlmen	gentlemen
gentilman	gentleman
gentilmans	gentlemen
gentle-woman	gentlewoman
gentleman-like	gentlemanlike
gentlemens	gentlemen
get'st	gettest
geten	got
gether	gather
gethered	gathered
getherin'	gathering
gett'st	gettest
getten	got
gettin	getting
gettin'	getting
gev	give
gi'	give
gi'en	given
gi'es	gives
gi'in	giving
gi'n	given
giant-like	giantlike
gie	give
gie't	give't
gies	gives
gild'st	gildest
gillyvors	gillyflowers
gin'ral	general
gin't	given't
girnning	grinning
girt	girded
git	get
gittin	getting
giv	give
giv'	give
giv'n	given
give-a	give
giveth	gives
givin	giving
givin'	giving
gladden'd	gladdened
glideth	glides
glose	gloze
glow-worm	glowworm
glow-worm's	glow's
glow-worms	glowworms
go'st	goest
goa	go
goan	gone
goas	goes
gobern	govern
god-daughter	goddaughter
goen	gone
goeth	goes
goin	going
goin'	going
goins-on	goings-on
good-by	good-bye
good-natur'd	good-natured
good-will	goodwill
goodness'	goodness's
gooid	good
goot	good
gospelled	gospeled
gossipping	gossiping
gossippings	gossipings
got'st	gottest
goth	goes
gots	gets
gotten	got
governor-General	governor-general
governor-General's	governor-general's
gownd	gown
gownds	gowns
gra-a-anadeers	grenadiers
graff	graft
graft	grafted
graft'st	graftest
gramercies	gramercy
gran	grand
gran'	grand
grand-children	grandchildren
grant'st	grantest
granteth	grants
grat	gratted
grave-maker	gravemaker
grave-stone	gravestone
gravelled	graveled
graven	graved
gray	grey
great'st	greatest
greatness'	greatness's
green-a	green
green-sickness	greensickness
greeteth	greets
grew'st	grewest
grey	gray
greybeards	graybeards
griped	gripped
grisled	grizzled
groaneth	groans
groon	groan
gropin	groping
ground-plot	groundplot
ground-work	groundwork
grovelled	groveled
grovelling	groveling
grow'd	growed
grow'st	growest
groweth	grows
grund	ground
gud	good
gude	good
gudewife	goodwife
guest-wise	guestwise
guid	guide
gulpins	gulpings
guv'ner	governor
gwine	going
ha!	ha
ha'in'	having
ha'ing	having
ha'it	have't
ha'n't	haven't
ha'nt	haven't
ha'penny	halfpenny
ha'porth	halfpenny-worth
ha'porths	halfpennyworths
ha't	have't
had'nt	hadn't
hadna	hadn't
hae	have
hae't	have't
hagh	how
hah	how
hahse	house
hahsiver	howsoever
hahsomdiver	howsoever
hain't	haven't
haint	haven't
hair's-breadth'	hair's-breadth's
hair-breadth	hairbreadth
half-moon	halfmoon
half-pence	halfpennies
halfpence	halfpennies
hallo	halloa
halloing	hallowing
hallow-Mass	hallow-mass
hame	home
han	have
han't	haven't
hand-fast	handfast
hand-writing	handwriting
handicrafts-men	handicraftsmen
handkercher	handkerchief
handkerchers	handkerchiefs
hang'st	hangest
hang-Ho	hang-ho
hangeth	hangs
hangin'	hanging
hanna	haven't
hany	any
hap'orth	halfpenny-worth
hap-hazard	haphazard
happed	happened
har'st	harvest
harbor	harbour
hard-handed	hardhanded
hare-brained	harebrained
hare-lip	harelip
harvest-man	harvestman
hasna	hasn't
haste-posthaste	haste-post-haste
hasteth	hastes
hatchin'	hatching
hateth	hates
hauding	holding
hauf	half
hav'n't	haven't
haveing	having
havena	haven't
havin	having
havin'	having
haviour	behaviour
havn't	haven't
hay-Seed	hay-seed
hazle	hazel
he'ld	he'd
head-aches	headaches
head-piece	headpiece
head-pieces	headpieces
head-spring	headspring
head-stall	headstall
headach	headache
headachs	headaches
headlongs	headlong
headstone	headstone's
healeth	heals
heap'st	heapest
hear'st	hearest
heard'st	heardest
heareth	hears
hearin	hearing
hearken	harken
hearkenin'	hearkening
hearkening	harkening
hearn	heard
heart-ache	heartache
heart-break	heartbreak
heart-burning	heartburning
heart-grief	heartgrief
heart-sore	heartsore
heart-string	heartstring
heart-struck	heartstruck
heaveth	heaves
heavy-headed	heavyheaded
heawse	house
heedfull'st	heedfullest
heelin'	heeling
heerd	heard
heern	heard
heggs	eggs
heighth	height
heigth	heighth
hell-born	hellborn
hell-hound	hellhound
hell-hounds	hellhounds
help'd	helped
help'st	helpest
helpin'	helping
helter-Skelter	helter-skelter
hemp-seed	hempseed
henderin'	hindering
her's	hers
herb-woman	herbwoman
herdmen	herdsmen
hereabouts	hereabout
hereself	herself
hersel	herself
hersel'	herself
hersell	herself
hersen	herself
heself	himself
hev	have
hevn't	haven't
hey	heigh
hey-day	heyday
hielands	highlands
high'st	highest
high-born	highborn
high-swoln	high-swollen
highness'	highness's
hild	held
hilloa	hillo
himsel	himself
himsell	himself
his'n	his
hissel	himself
hisself	himself
hisseln	himself
hist'ry	history
hitherwards	hitherward
ho!	ho
hoary-headed	hoaryheaded
hobby-horse	hobbyhorse
hof-Marschall	hof-marschall
hoise	hoist
hoised	hoist
hoisted	hoist
hold'st	holdest
hold-fast	holdfast
holden	held
holdeth	holds
holdin'	holding
holla'd	hallowed
hollaing	hallowing
holloa	hallow
holloa'd	hallowed
hollodays	holidays
hollow-hearted	hollowhearted
holp	helped
holp'st	helpedest
holydays	holidays
home-bred	homebred
homewards	homeward
homlets	omelettes
hond	hound
honey-bees	honeybees
honey-drops	honeydrops
honor	honour
honorable	honourable
honored	honoured
honoring	honouring
honors	honours
honour'd	honoured
hoo	ho
hoo'd	who'd
hoo's	who's
hoo-Hall	hoo-hall
hood-wink'd	hoodwinked
hopless	hopeless
hopp'd	hopped
hoppin'	hopping
horrud	horrid
horse-Guards	horse-guards
horse-Quarter	horse-quarter
horse-hairs	horsehairs
horse-leeches	horseleeches
horse-shoe	horseshoe
horse-tail	horsetail
horse-way	horseway
hoss	horse
hosses	horses
hostess'	hostess's
hot-house	hothouse
hould	hold
houlerying	hollering
hour-glass	hourglass
hous'ever	howsoever
house-room	houseroom
hove	heaved
hove-to	heaved-to
howd	hold
howe	how
howe'er	however
howiver	however
howl'st	howlest
hows'ever	howsoever
howsever	howsoever
howsoe'er	howsoever
howsome'er	howsoever
howsomever	howsoever
hoyday	heyday
hugger-mugger	huggermugger
humble-bee	humblebee
humor	humour
humors	humours
humph!	humph
hunch-backed	hunchbacked
hunteth	hunts
huntress'	huntress's
hup	up
hup'ards	upwards
hupstarts	upstarts
hurricanoes	hurricanes
hurtin'	hurting
hush'd	hushed
huswifery	housewifery
hve	have
hwhat's	what's
hæ	have
i'	I
i'faith	faith
i'ii	I'll
i'stid	instead
i'th'	i'th
ice-brook's	ice's
idee	idea
idle-headed	idleheaded
ilbow	elbow
ile	oil
ilka	ilk
ill-headed	ill-head
ill-natur'd	ill-natured
ill-ta'en	ill-taken
illhumour	ill-humour
illumineth	illumines
impanelled	impaneled
impanneled	impaneled
imparteth	imparts
imperilled	imperiled
impinge	impinging
importancy	importance
importeth	imports
impudency	impudence
in-deed	indeed
in-doors	indoors
incardinate	incarnate
inch-meal	inchmeal
inclose	enclose
inclosed	enclosed
inclosing	enclosing
inclosures	enclosures
incommóded	incommoded
increaseth	increases
incumbrance	encumbrance
incumbrances	encumbrances
incuring	incurring
indrenched	endrenched
indue	endue
indued	endued
indues	endues
indurance	endurance
infatyated	infatuated
inferreth	infers
infold	enfold
inforced	enforced
ingin	indian
inions	onions
inkwhich'd	inkwhiched
innercent	innocent
innured	enured
insconce	ensconce
insculped	ensculpted
insinuateth	insinuates
insistes	insists
instructin'	instructing
int'	into
int'rests	interests
intend'st	intendest
intendeth	intends
inter'gatories	interrogatories
inter'gatory	interrogatory
interessed	interested
interestin'	interesting
interferin'	interfering
interrupt'st	interruptest
intirely	entirely
intituled	entitled
intreat	entreat
intreaties	entreaties
intrenched	entrenched
introjuicing	introducing
intructions	instructions
intrusted	entrusted
intuh	into
inuendo's	innuendoes
inuendoes	innuendoes
inveigleth	inveigles
inwards	inward
is'nt	isn't
ish	is
isna	isn't
istead	instead
it'	it
ith	is
itsseln	itself
iudulgencies	indulgencies
iver	ever
ivery	every
iverybody'll	everybody'll
iverythin'	everything
iverything	everything
jack'nape	jackanapes
jack-an-ape	jackanapes
jack-towelling	jack-toweling
jackalls	jackals
janizzaries	janissaries
jarteer	garter
jav'lins	javelins
jaw-bone	jawbone
jawin'	jawing
jes	just
jew'llery	jewelry
jewelled	jeweled
jewess'	jewess's
jined	joined
jis	just
jist	just
jockied	jockeyed
join'st	joinest
joineth	joins
joint-stool	jointstool
jokin	joking
jolt-head	jolthead
joltheads	jolt-heads
jonas-in-the-Whale	jonas-in-the-whale
joosy	juicy
journies	journeys
joyin'	joying
judgeth	judges
judgment	judgement
jumpeth	jumps
jumpin'	jumping
justice'	justice's
justs	jousts
keenning	keening
keep'st	keepest
keepin'	keeping
kend	kenned
kenn'd	kenned
kennelled	kenneled
kep	kept
kept'st	keptest
ketch	catch
ketches	catches
kettle-drum	kettledrum
key-hole	keyhole
kickin'	kicking
kickshawses	kickshaws
kill'st	killest
kill-e	kill
killedst	killedest
killen	kill
killeth	kills
killin'	killing
kind'st	kindest
kindhearted	kind-hearted
kindness'	kindness's
kine	cows
king-Post	king-post
kitchen-Stuff	kitchen-stuff
kitchin	kitchen
knelt	kneeled
knew'st	knewest
knitted	knit
knitteth	knits
knittin'	knitting
knockin'	knocking
knot-grass	knotgrass
know'dst	knewest
know'st	knowest
knowd	knew
knowed	known
knoweth	knows
knowin'	knowing
knuekles	knuckles
kyloes	kylos
l'arnin'	learning
labelled	labeled
labor	labour
labor-saving	labour-saving
labored	laboured
laboring	labouring
labors	labours
labour'st	labourest
labourine	labouring
lack'st	lackest
lack-lustre	lacklustre
laden	loaded
lady-like	ladylike
laid'st	laidest
laiking	liking
lament'st	lamentest
lanceth	lances
lang	long
langer	longer
langest	longest
langour	languor
languisheth	languishes
lanthorn	lantern
larming	learning
larn	learn
larnin	learning
larning	learning
larnt	learned
larum	alarm
latin	Latin
laugh'st	laughest
laugheth	laughs
laughin'	laughing
laund	land
lavin'	laving
law-List	law-list
law-Writing	law-writing
law-breaker	lawbreaker
lay'st	layest
layed	laid
layeth	lays
layin'	laying
layn	lain
lead'st	leadest
leaded	led
leadeth	leads
leant	leaned
leap-frog	leapfrog
leaped	leapt
leapin'	leaping
learnd	learned
learnt	learned
leavin'	leaving
led'st	leddest
leeding	leading
leese	lose
leetle	little
leived	believed
len'	lend
lendeth	dares
lenght	length
lente	leaned
let'st	lettest
let-a	let
letten	let
lettin'	letting
lettrs	letters
leuked	looked
leve	leave
levelled	leveled
levelling	leveling
levre	lever
libbard's	leopard's
libelling	libeling
lick'st	lickest
lien	lain
lieth	lies
lieut	lieutenant
lieutenant-Colonel	lieutenant-colonel
lieutenant-Colonels	lieutenant-colonels
lieutenant-General	lieutenant-general
life-Buoy	life-buoy
life-blood	lifeblood
life-time	lifetime
liftin'	lifting
light-colored	light-coloured
light-foot	lightfoot
lightening	lightning
lighteth	lights
lik'st	likest
likedst	likedest
likin'	liking
lime-kiln	limekiln
limekilns	lime-kilns
liquor	liquour
liquors	liquours
lissom'st	lissomest'
listeth	lists
littl'	little
little-a	little
liv'st	livest
livedst	livedest
liveth	lives
livin'	living
lkie	like
loaden	loaded
loike	like
loikes	likes
long'st	longest
long-a	long
long-favored	long-favoured
long-tail	longtail
look'd	looked
look'dst	lookedest
look'st	lookest
look-e	look
look-out	lookout
lookedst	lookedest
looketh	looks
lookin	looking
lookin'	looking
lookst	lookest
loop-holes	loopholes
loose-Fish	loose-fish
loosing	losing
loove's	love's
lor	lord
lor'	lord
loseth	loses
losin'	losing
loth	loath
loud'st	loudest
louis-Quatorze-gimcracks	louis-quatorze-gimcracks
lour'st	lourest
loureth	lours
lov'd	loved
love-Truths	love-truths
love-a	love
love-letters	loveletters
love-sick	lovesick
love-songs	lovesongs
lovedst	lovedest
loveth	loves
lovin'	loving
loyal'st	loyalest
lurketh	lurks
lusts	lustest
lute-string	lutestring
lym	lyam
lyon	lion
l’Écossaise	l’écossaise
ma'	make
ma'-shift	makeshift
ma'am	madam
ma'in'	making
mabbe	maybe
mach	much
mad'st	madest
mad-brain	madbrain
mad-brained	madbrained
mad-headed	madheaded
mae	more
maggit's	maggot's
main-top	maintop
maine	main
mained	maimed
mair	more
maist	mayest
maister	master
maister's	master's
maisters	masters
majestee	majesty
major-General	major-general
mak	make
make-a	make
maketh	makes
makin'	making
makking	making
maks	makes
malecontent	malcontent
malic	malice
mammas	mamas
man-child	manchild
man-like	manlike
man-of-War's	man-of-war's
man-queller	manqueller
manifactures	manufactures
manor-House	manor-house
mantle-piece	mantlepiece
manœuvred	manoeuvered
mar'ge	marriage
mar'ied	married
marble-hearted	marblehearted
marchant	merchant
marcheth	marches
marcies	mercies
marcy	mercy
margent	margin
margents	margins
mark'd	marked
mark-man	markman
marketh	marks
marning	morning
marquess	marquis
marr'in'	marrying
marr'ing	marrying
marriage-bed	marriagebed
marryin	marrying
marshall'st	marshalest
marshalled	marshaled
marshalling	marshaling
marvell'st	marvelest
marvelled	marveled
marvelling	marveling
mas'r	master
mas'r'll	master'll
mas'r's	master's
mas'rs	masters
masse	mass
mast-Head	mast-head
master-pieces	masterpieces
masterfu'	masterful
mat-Maker	mat-maker
match-making	matchmaking
matcheth	matches
mater'als	materials
math'matics	mathematics
matter-a	matter
maun	must
may'st	mayest
mayna	mayn't
mayst	mayest
meagre	meager
mean'st	meanest
meaneth	means
meant'st	meantest
measter's	master's
mebbe	maybe
med'cinable	medicinable
meditatin'	meditating
meet'st	meetest
meet-a	meet
meetin	meeting
meetin'	meeting
meetin's	meeting's
meeting-place	meetingplace
meks	makes
melancholly	melancholy
melo-dramas	melodramas
melo-dramatic	melodramatic
melteth	melts
meltin'	melting
mementoes	mementos
memoranda	memorandum
memorandums	memoranda
memorize	memorise
men-of-War	men-of-war
menage	manage
mendin'	mending
mens'	men's
menservants	manservants
merks	marks
mervailous	marvelous
mesdames	madames
mesters	masters
met'orological	meteorological
met'st	mettest
methoughts	methought
mi-Lord	mylord
mickle	much
mid-day	midday
might'st	mightest
mightst	mightest
milch-kine	milk-cows
mile'	miles
mile-a	mile
milk-House	milk-house
milk-sop	milksop
milk-white	milkwhite
milor	milord
min	man
min'	man
minit	minute
minsthrel	minstrel
mis'able	miserable
mis'rable	miserable
mis-dread	misdread
mis-judging	misjudging
mis-judgment	misjudgment
mis-termed	mistermed
misbegot	misbegotten
misdoubteth	misdoubts
misfortanes	misfortunes
mislikins	mislikings
misse	miss
misshaped	misshapen
missin'	missing
missis'	missis's
missus	missis
mista'en	mistaken
mistak'st	mistakest
mistaketh	mistakes
mistres	mistress
mistress'	mistress's
mistresship	mistress-ship
mitch	much
mlud	milord
moche	much
mock'st	mockest
mockvater	mockwater
mod'rn	modern
modelled	modeled
modelling	modeling
moe	more
moin	mine
molten	melted
monies	moneys
mony	money
moralize	moralise
moreo'er	moreover
morever	moreover
mornin'	morning
mosquitos	mosquitoes
mosse	moss
mother-wit	motherwit
mottos	mottoes
mought	might
mouldeth	moulds
moulten	moulted
mounteth	mounts
mourn'd	mourned
mouse-trap	mousetrap
mousquetaires	musketeers
mout	mouth
moveable	movable
moveables	movables
moveth	moves
mr	Mr.
mr.	Mr.
mrs	Mrs.
mrs.	Mrs.
muh	may
muleters	muleteers
mumn't	mustn't
mun	must
mun'n't	mustn't
munn't	mustn't
munna	mustn't
munny	money
murd'ring	murdering
murder'd	murdered
murder'st	murderest
murmur'st	murmurest
murther	murder
murthering	murdering
mus'n't	mustn't
mush	much
musket's-Mother	musket's-mother
musn't	mustn't
mustna	mustn't
mutine	mutiny
mutiners	mutineers
mutsn't	mustn't
mutter'd	muttered
mysel	myself
mysel'	myself
mysell	myself
n'old	wouldn't
n't	not
n-no	no
na'	not
nae	no
naebody	nobody
naething	nothing
nah	no
naig	nag
naigs	nags
nailes	nails
nane	none
narrowin'	narrowing
nat'lly	naturally
nat'ral	natural
nat'rally	naturally
nathless	natheless
nathlesses	natheless
natur	nature
natur'	nature
natur's	nature's
naught	nought
nayther	neither
nayver	never
naïIvely	naïively
nd	and
ne'er	never
ne'er-cloying	never-cloying
ne'er-do-good	never-do-good
ne'er-do-weel	never-do-well
ne'er-lust-wearied	never-lust-wearied
ne'er-touched	never-touched
ne'er-yet-beaten	never-yet-beaten
ne'erchanging	never-changing
ne'ertheless	nevertheless
near'st	nearest
neat-herd's	neatherd's
neat-herds	neatherds
neaw	now
nebour	neighbour
neebors	neighbours
need'st	needest
needeth	needs
needna	needn't
neeght	night
neele	needle
neerest	nearest
neerly	nearly
neglect'st	neglectest
negociating	negotiating
neighbor	neighbour
neighbored	neighboured
neighboring	neighbouring
neighbors	neighbours
neightbours	neighbours
nereides	nereids
nett	net
nevare	never
nevvy	nephew
new'st	newest
new-come	newcome
new-fall'n	new-fallen
new-fangled	newfangled
new-found	newfound
new-ta'en	new-taken
news-Letter	news-letter
night-Hag	night-hag
night-Watch	nightwatch
night-bird	nightbird
night-cap	nightcap
night-caps	nightcaps
night-gown	nightgown
night-mare	nightmare
night-walking	nightwalking
night-watch	nightwatch
nill	won't
nine-fold	ninefold
niver	never
nivir	never
no!	no
no-bodies	nobodies
noa	not
noabody	nobody
nob'dy	nobody
nod-Ay	nod-ay
noder	another
non-existence	nonexistence
non-payment	nonpayment
noo	no
noon-day	noonday
nor'	north
nor'ard	northward
nor-Westers	nor-westers
north'ard	northward
north-West	northwest
north-east	northeast
north-west	northwest
not'ing	nothing
note-book	notebook
noteth	notes
nother	neither
nothin	nothing
nothin'	nothing
nothink	nothing
nough	enough
nourisheth	nourishes
nousle	nuzzle
now-a-days	nowadays
nowhar	nowhere
nowheres	nowhere
nowt	nought
nto	unto
nuncio's	nuntio's
nurseth	nurses
nursh-a	nurse
nussin'	nursing
nuthook's	nut-hook's
nymphes	nymphs
o	oh
o'	of
o'er	over
o'er-laboured	over-labored
o'erbear	overbear
o'erbearing	overbearing
o'erbears	overbears
o'erbeat	over-beat
o'erblows	overblows
o'erboard	overboard
o'erborne	overborne
o'ercame	overcame
o'ercast	overcast
o'ercharged	overcharged
o'ercharging	overcharging
o'ercloyed	overcloyed
o'ercome	overcome
o'ercount	overcount
o'ercovered	overcovered
o'ercrows	overcrows
o'erdoing	overdoing
o'erdusted	overdusted
o'erdyed	over-dyed
o'ereaten	over-eaten
o'ereye	over-eye
o'erfed	overfed
o'erflourished	overflourished
o'erflow	overflow
o'erflowed	overflowed
o'erflowing	overflowing
o'erflows	overflows
o'erfraught	overfraught
o'ergalled	overgalled
o'erglanced	overglanced
o'ergone	overgone
o'ergreat	over-great
o'ergreen	overgreen
o'ergrow	overgrow
o'ergrown	overgrown
o'ergrowth	overgrowth
o'erhang	overhang
o'erhanging	overhanging
o'erhasty	overhasty
o'erhear	overhear
o'erheard	overheard
o'erjoyed	overjoyed
o'erlaboured	over-labored
o'erleap	overleap
o'erleaps	overleaps
o'erleavens	overleavens
o'erlook	overlook
o'erlooked	overlooked
o'erlooking	overlooking
o'ermasterest	overmasterest
o'ermatched	overmatched
o'ermount	overmount
o'ernight	overnight
o'ernight's	overnight's
o'erpaid	overpaid
o'erparted	overparted
o'erpast	overpassed
o'erpays	overpays
o'erpeer	overpeer
o'erperch	overperch
o'erpicturing	overpicturing
o'erposting	overposting
o'erpowered	overpowered
o'erpressed	overpressed
o'erprized	overprized
o'errate	overrate
o'erraught	overreached
o'erreach	overreach
o'erreaches	overreaches
o'erreaching	overreaching
o'erread	overread
o'errule	overrule
o'erruled	overruled
o'errules	overrules
o'errun	overrun
o'erruns	overruns
o'erset	overset
o'ershade	overshade
o'ershades	overshades
o'ershine	overshine
o'ershot	overshot
o'ershowered	overshowered
o'ersized	oversized
o'erskip	overskip
o'erslips	overslips
o'ersnowed	oversnowed
o'erspread	overspread
o'erspreads	overspreads
o'erstare	overstare
o'erstep	overstep
o'erstrawed	overstrawed
o'erstunk	overstunk
o'ersway	oversway
o'ersways	oversways
o'erswell	overswell
o'erta'en	overtaken
o'ertake	overtake
o'erteemed	over-teemed
o'erthrow	overthrow
o'erthrown	overthrown
o'erthrows	overthrows
o'ertook	overtook
o'ertop	overtop
o'ertopping	overtopping
o'ertrip	overtrip
o'erturn	overturn
o'ervalues	overvalues
o'erwalk	overwalk
o'erwatched	overwatched
o'erween	overween
o'erweening	overweening
o'erweens	overweens
o'erweigh	overweigh
o'erweighs	overweighs
o'erwhelm	overwhelm
o'erwhelmed	overwhelmed
o'erwhelming	overwhelming
o'erworn	overworn
o'erwrested	overwrested
o'erwrought	overwrought
o'nothing	nothing
o's	of's
o'things	things
ober	over
obeyed'st	obeyedest
obleeged	obliged
obleeging	obliging
oblig'd	obliged
observancy	observance
occassion	occasion
oder	other
odor	odour
odors	odours
oe'red	overed
of'em's	of'em
of-fhand	off-hand
ofetn	often
offend'st	offendest
offendeth	offends
offer'st	offerest
offert	offered
office-badge	officebadge
officers-at-arms	officer-at-arms
oft-times	ofttimes
oh	o
oh!	oh
oho!	oho
omitt'st	omittest
on'y	only
oncommon	uncommon
onlucky	unlucky
onreasonable	unreasonable
onst	once
ontrys	entries
onwards	onward
onybody	anybody
oped	opened
open-heartedness	openheartedness
opers	operas
opes	opens
oppen't	open't
oppresseth	oppresses
or'nary	ordinary
orful	awful
orter	ought
osses	horses
othergates	othergate
ou	you
oud	old
oughter	ought
oughtna	oughtn't
oughts	ought
ould	old
our'n	ours
our's	ours
oursel	ourselves
ourself	ourselves
oursels	ourselves
oursens	ourselves
ousels	ourselves
out-Churchill'd	out-Churchilled
out-shining	outshining
out-wall	outwall
outgoes	outgos
outwards	outward
over-careful	overcareful
over-rated	overrated
over-running	overrunning
over-salt	oversalt
overcanopied	over-canopied
overcool	over-cool
overdaring	over-daring
overearnest	over-earnest
overgoes	overgos
overgreedy	over-greedy
overhandled	over-handled
overhappy	over-happy
overheard'st	overheardest
overpartial	over-partial
overred	over-red
overta'en	overtaken
overtaketh	overtakes
overweathered	overweather
ow	how
ow'd	old
ow't	aught
owedst	owedest
oweth	owes
owt	aught
ox-head	oxhead
p'ints	points
p'isin	pissing
p'r'aps	perhaps
p'raps	perhaps
p'rhaps	perhaps
p.m.	P.m.
pa'	pa
pabble	babble
pacific	Pacific
pack-saddle	packsaddle
paine	pain
pained'st	painedest
pajock	peacock
palateable	palatable
palfreys	palfries
pandars	panders
panelled	paneled
panelling	paneling
pannels	panels
panteth	pants
pantin'	panting
paper-mill	papermill
parcelled	parceled
parcelling	parceling
parchmentses	parchments
parfect	perfect
park-ward	parkward
parlous	perilous
parridge	porridge
parti-coloured	particoloured
partic'lar	particular
partic'ler	particular
pashful	bashful
pass'd	passed
passeth	passes
passin'	passing
pastiles	pastilles
patines	patens
patrolled	patroled
patrolling	patroling
patronizingly	patronisingly
pattle	battle
pawin'	pawing
pawsed	paused
payed	paid
payement	payment
payne	pain
peacably	peaceably
peace-a	peace
peace-maker	peacemaker
peard	beard
peartest	pertest
peaten	beaten
pecular	peculiar
peddlin'	peddling
peds	beds
peereth	peers
pell-mell	pellmell
pence	pennies
pencilled	penciled
penn'orth	pennyworth
pennyworths	penny-worths
pent	penned
peradventures	peradventure
perceiveth	perceives
peregrinanations	peregrinations
perfect'st	perfectest
peril'd	periled
perilled	periled
perisheth	perishes
permiscus	promiscuous
perry	very
perserved	preserved
pertaking	partaking
pervide	provide
peseech	beseech
petar	petard
petter	better
pew-fellow	pewfellow
phenomonons	phenomena
phoenix'	phoenix's
pianforté	pianoforte
piano-forte	pianoforte
pianoforté	pianoforte
pible	bible
pic-nic	picnic
pick-axe	pickaxe
pick-thanks	pickthanks
pickaxes	pick-axes
picketted	picketed
pickin'	picking
picquetted	picqueted
pictur	picture
picturs	pictures
pid	bid
pierceth	pierces
pilcher	pilchard
pill	peel
pilled	peeled
pinche	pinch
pineth	pines
pinse	pinch
pint-pot	pintpot
pioner	pioneer
pioners	pioneers
pish'd	pished
pisoned	poisoned
pistolling	pistoling
pitied'st	pitiedest
pittie-ward	pity-ward
pityin'	pitying
placeth	places
plaintive's	plaintiff's
plaister	plaster
planteth	plants
plats	plaits
platted	plaited
play'd	played
play'st	playest
playedst	playedest
playeth	plays
playfellows	play-fellows
pleadeth	pleads
pleasant'st	pleasantest
pleaseth	pleases
pleasurin'	pleasuring
pled	pleaded
plesantly	pleasantly
pless	bless
plessed	blessed
plessing	blessing
plood	blood
ploody	bloody
plough'st	ploughest
plow	blow
plows	blows
pluck'st	pluckest
plue	blue
plum-tree	plumtree
plurisy	pleurisy
pocket-book	pocketbook
pody	body
point'st	pointest
point-devise	point-device
pold	bold
poll-axe	pole-axe
pommelled	pommeled
poney	pony
poor'st	poorest
pop'lar	popular
popedome	popedom
pore	poor
porn	born
porpus	porpoise
portcullised	portcullissed
portuguese	Portuguese
possesseth	possesses
post-Captain	post-captain
post-Office	post-office
poste	post
pothecary	apothecary
pottle-pot's	pottle's
pour'st	pourest
pourtray	portray
pouts	poutest
poys	boys
practiques	practics
pragging	bragging
praichin'	preaching
prain	brain
prains	brains
praisin'	praising
praries	prairie
prave	brave
prawls	brawls
pray'st	prayest
prayer-Books	prayer-books
prayin	praying
prayin'	praying
pre-contract	precontract
pre-eminence	preeminence
pre-ordinance	preordinance
preachin'	preaching
preachins	preachings
pread	bread
preceesely	precisely
predeceased	pre-deceased
preeches	breeches
preferr'st	preferrest
preferreth	prefers
prentice	apprentice
prerogatifes	prerogatives
prerogatived	prerogative
presageth	presages
present'st	presentest
presenteth	presents
press'd	pressed
prest	pressed
presumes	presumest
prevaileth	prevails
prevent'st	preventest
prick-song	pricksong
pridge	bridge
prief	brief
prince'	prince's
prince-like	princelike
princess'	princess's
prings	brings
prison-house	prisonhouse
priviliges	privileges
proclaimeth	proclaims
procoeding	proceeding
proctor	Proctor
procure-a	procure
promised'st	promisedest
promiseth	promises
promisin'	promising
prong	pronged
prophecying	prophesying
prophesies	prophecies
prophesy'd	prophesied
proposin	proposing
proud'st	proudest
proud-hearted	proudhearted
proveth	proves
provoketh	provokes
pry'st	priest
pryed	pried
pryin'	prying
pudding-Headed	pudding-headed
puffeth	puffs
puir	poor
pumpion	pompion
punds	pounds
purchaseth	purchases
purhaps	perhaps
purposeth	purposes
pursents	presents
purty	pretty
push-pin	pushpin
put'st	puttest
putter	butter
puttin'	putting
puzzel	puzzle
py'r	by'r
pye	pie
pyramides	pyramids
pyramis	pyramid
pyramises	pyramids
qu	queen
quarl'd	quarreled
quarrelled	quarreled
quarrelling	quarreling
quarrelous	quarrellous
quarter-Deck	quarter-deck
quarter-staves	quarter-staffs
quashimaboo-Aid	quashimaboo-aid
queen-Gold	queen-gold
questionedst	questionedest
quetioned	questioned
quick'st	quickest
quick-sands	quicksands
quick-sighted	quicksighted
quire	choir
quiring	choiring
quitted	quit
quiver'st	quiverest
quoite	quite
raal	real
raced	razed
racin'	racing
rael	real
rageth	rages
ragg	rag
ragged'st	raggedest
rahm	room
rahnd	round
raight	right
rail'st	railest
raileth	rails
railly	really
raily	really
raine	rain
raineth	rains
raisin'	raising
ran'st	ranst
rann	ran
rat-catcher	ratcatcher
rattlin'	rattling
raught	reached
ravelled	raveled
ravin	ravine
ravin'	raving
raybels	rebels
rayly	really
rayther	rather
razeth	razes
re'lly	really
re'ly	really
re-appeared	reappeared
re-assured	reassured
re-composing	recomposing
re-crossed	recrossed
re-salute	resalute
re-send	resend
re-united	reunited
re-word	reword
reacheth	reaches
read'st	readest
readin'	reading
realised	realized
rearin'	rearing
reawnd	round
rebused	abused
rec-eive	receive
recal	recall
recals	recalls
receiver-General	receiver-general
receiveth	receives
reched	reached
recketh	recks
reckin	reckon
recompence	recompense
red-Men	red-men
red-hot	redhot
redd	red
redden'd	reddened
redeem'st	redeemest
rediculous	ridiculous
reeleth	reels
reely	really
refering	referring
reft'st	reftest
reg'lar	regular
reg'mentals	regimentals'
reglar	regular
reign'd	reigned
reigneth	reigns
rein'd	reined
rejoiceth	rejoices
relenteth	relents
relick	relic
relieveth	relieves
reliques	relics
relishin'	relishing
remaineth	remains
remember'st	rememberest
rememebered	remembered
renew'd	renewed
renown'd	renowned
repeat'st	repeatest
report'st	reportest
reposeth	reposes
reproche	reproach
reproveable	reprovable
reprovedst	reprovedest
requireth	requires
requit	requited
rere-mice	rear-mice
resembleth	resembles
resign'd	resigned
resisteth	resists
resolveth	resolves
respect'st	respectest
resteth	rests
restrain'st	restrainest
rether	rather
retored	restored
return'd	returned
return'st	returnest
returne	return
returneth	returns
reuturned	returned
rev'rince	reverence
revelled	reveled
revelling	reveling
reverend'st	reverendest
reviveth	revives
rhumatis	rheumatis
riband	ribbon
ribands	ribbons
ribaudred	ribald
ribband	ribbon
ribbin	ribbon
ribbins	ribbons
rideth	rides
ridin'	riding
rigg'st	riggest
right-Whale	right-whale
ringin'	ringing
ript	ripped
ris'	risen
riseth	rises
rivalled	rivaled
rivelled	riveled
rivetted	riveted
road-way	roadway
roarin	roaring
robb'st	robbest
rock'd	rocked
rockin'	rocking
roos	rose
rooteth	roots
rope-maker	ropemaker
rose-water	rosewater
rough-cast	roughcast
roun'	round
rouseth	rouses
row'd	rowed
royalise	royalize
rrcollections	recollections
rubben	rubbing
rubbidge	rubbish
ruin'd	ruined
rullers	rulers
rumors	rumours
run-away	runaway
runn'st	runnest
runnin'	running
ruther	rather
ryde	ride
rye-straw	ryestraw
s'ciety	society
s'd	should
s'pect	expect
s'pose	suppose
sa'	save
sa'ce	sauce
saddle-bow	saddlebow
sae's	so's
sag-Harbor	sag-harbor
sair	sore
saith	says
sall	shall
sallet	salad
sallets	salads
salt-fish	saltfish
saluteth	salutes
samphire	sampire
sandalled	sandaled
sangviches	sandwiches
sangwitches	sandwiches
sarcenet	sarsenet
sarmon	sermon
sarmons	sermons
sartain	certain
sartin	certain
sartin'	certain
sarve	serve
sarved	served
sate	sat
sav'd	saved
savin'	saving
savins	savings
saw'st	sawest
sawin'	sawing
saxpence	sixpence
say'st	sayest
sayd	said
sayin'	saying
sayst	sayest
scald'st	scaldest
scape	escape
scaped	escaped
scapeth	escapes
scase	scarce
scath	scathe
sceptered	sceptred
schal	shall
scholards	scholars
scimetars	scimitars
scissars	scissors
scoldt	scolded
scolloped	scalloped
sconses	sconces
scorn'st	scornest
scornedst	scornedest
scottish	Scottish
scrapin'	scraping
scratchin'	scratching
scratchins	scratchings
screachin'	screeching
screamin'	screaming
screech-owl	screechowl
screechin'	screeching
scrougin'	scrouging
scrowdging	scrouging
se'nnight	sevennight
se'nnight's	sevennight's
se'nnights	sevennights
sea-boy	seaboy
sea-like	sealike
sea-maid's	seamaid's
sea-mark	seamark
sea-salt	seasalt
sea-shore	seashore
sea-sick	seasick
sea-side	seaside
sea-water	seawater
seafarer	sea-farer
sealing-Wax	sealing-wax
season-on-the-Line	season-on-the-line
sech	such
secmed	seemed
secresy	secrecy
secret'st	secretest
see'st	seest
seeats	seats
seein'	seeing
seek'st	seekest
seem'd	seemed
seem'st	seemest
seemeth	seems
sees't	seest
seese	cheese
seignior	signior
seignories	signories
seizeth	seizes
self-controul	self-control
self-love	selflove
self-misued	self-misused
sellin'	selling
semeth	seems
send'st	sendest
send-a	send
sendeth	sends
sent'st	sentest
sentinelled	sentineled
sepulchred	sepulchered
sepulchring	sepulchering
ser'ous	serious
seris	serious
serjeant	sergeant
serjeants	sergeants
serjeants'	segeants'
serv'd	served
serveth	serves
ses	says
sespicion	suspicion
set'st	settest
setted	set
setten	set
settin'	setting
seven-night	sevennight
sh'	she
sha'n't	shan't
sha'nt	shan't
sha't	shalt
shaamed	shamed
shader	shadow
shadow-like	shadowlike
shakin'	shaking
shaksperian	Shakespearean
shallenge	challenge
shalln't	shan't
shame-faced	shamefaced
shanna	shan't
shant	shan't
sharp'st	sharpest
shawn't	shan't
she'ld	she'd
she-Wolf	she-wolf
sheamfully	shamefully
sheep-biter	sheepbiter
sheep-hook	sheephook
sheep-shearing	sheepshearing
sheep-skin	sheepskin
sheep-skins	sheepskins
shelter'd	sheltered
shew	show
shewed	showed
shewing	showing
shewn	shown
shews	shows
shif'less	shiftless
shifless	shiftless
shineth	shines
shipwrack	shipwreck
shodld	should
shoo	she
shoo'll	she'll
shoo's	she's
shoon	shoes
shooteth	shoots
short'st	shortest
shortenin'	shortening
should'nt	shouldn't
should'st	shouldst
shouldna	shouldn't
shovelled	shoveled
show'd	showed
show'st	showest
showd	shown
showin'	showing
shrieve's	sheriff's
shrivelled	shriveled
shrove-tide	shrovetide
shrowd	shroud
shrows	shrews
shrug'st	shruggest
shyed	shied
sic	such
siccan	such
sich	such
sicilian	Sicilian
sick-fall'n	sick-fallen
sicken'd	sickened
sidier	soldier
siftin'	sifting
sigh'st	sighest
siller	silver
silling	shilling
sin'	since
sing'lar	singular
sing'st	singest
singe	sing
singeth	sings
singin	singing
singin'	singing
sinketh	sinks
sinne	sin
sinnifies	signifies
sipt	sipped
sirnames	surnames
sis's	sister's
sit'st	sittest
sithence	since
sitteth	sits
sittin	sitting
sittin'	sitting
six-or-seven-times-honoured	six-or-seven-times-honored
sixpences	sixpence
sixpenn'orth	sixpenny-worth
skeery	scary
skeeter	mosquito
slaketh	slakes
slanderin'	slandering
slandthering	slandering
slap-Bang	slap-bang
slappin'	slapping
slash'd	slashed
slave-like	slavelike
slayeth	slays
sleave	sleeve
sleep'st	sleepest
sleepe	sleep
slep	slept
slew'st	slewest
slip-shod	slipshod
slipt	slipped
slomber	slumber
slyly	slily
sma'	small
smackin'	smacking
small'st	smallest
small-e	small
smell'st	smellest
smelt	smelled
smiledst	smiledest
smilin	smiling
smilin'	smiling
smiteth	smites
smoaking	smoking
smooth'st	smoothest
smooth-pates	smoothy-pates
smother'st	smotherest
snapp'st	snappest
snapt	snapped
snarleth	snarls
snipt-taffeta	snipt-taffata
so'	so
so'ger	soldier
soa	so
soakin'-in	soaking-in
soe'er	soever
soft-hearted	softhearted
soh	so
solder'st	solderest
solidares	solidars
soly	solely
sombre	somber
somer	somewhere
somethin'	something
somethink	something
sometimes	sometime
somewhar	somewhere
somewheres	somewhere
son-in-laws	sons-in-law
sonatta	sonata
sone	soon
sopha	sofa
sor	saw
sorowfully	sorrowfully
sorteth	sorts
sou'-wester	south-wester
sought'st	soughtest
sould	should
south'ard	southward
south-west	southwest
sovereign'st	sovereignest
sowd	sown
spak	spoke
spake	spoke
spakes	speaks
spakest	spokest
spanish	Spanish
speak'st	speakest
speak-a	speak
speak-e	speak
speaketh	speaks
speakin'	speaking
specs	expects
spect	expect
spected	expected
spectin	expecting
spects	expects
speeded	sped
speedly	speedily
speken	speak
spelt	spelled
spend'st	spendest
sperm-Whale	sperm-whale
sperma-ceti	spermaceti
sperr	spur
sperrit	spirit
spicin'	spicing
spileing	spoiling
spilin'	spilling
spilt	spilled
spinnin'	spinning
spiralling	spiraling
spirit-Spout	spirit-spout
splendor	splendour
split'st	splittest
splitted	split
spoilt	spoiled
spos-ee	suppose
spouter-Inn	spouter-inn
sprang'st	sprangest
sprange	sprang
sprawl'st	sprawlest
spring-time	springtime
springeth	springs
springin'	springing
sprited	spirited
spung'd	spunged
spur'd	spurred
spurn'st	spurnest
spy'st	spiest
squier	squire
squire's'	squire's
squoire's	squire's
st	saint
stab'st	stabbedst
stablish	establish
stablishment	establishment
staid	stayed
staineth	stains
stalkin'	stalking
stan'	stand
stanchless	staunchless
stand'st	standest
standers-of-mast-heads	stander-of-mast-heads
standeth	stands
standin'	standing
standst	standest
stannin'	standing
stanning	standing
stans	stands
star-gazers	stargazers
starin'	staring
start-up	startup
starteth	starts
startin'	starting
starveth	starves
starvin	starving
stattits	statutes
stay'st	stayest
stayin'	staying
stealeth	steals
stearing	staring
stedfast	steadfast
stedfastly	steadfastly
steep-down	steepdown
stencilled	stenciled
stepp'd	stepped
stept	stepped
stern'st	sternest
stick'st	stickest
stickin'	sticking
stiddy	steady
stile-a	stile
still-born	stillborn
still-stand	stillstand
stingeth	stings
stipt	stepped
stirr'st	stirrest
stirreth	stirs
stirrin'	stirring
stirrup-Cup	stirrup-cup
stoccadoes	stoccatas
stock-Exchange	stock-exchange
stock-fish	stockfish
stockens	stockings
stockins	stockings
stol'n	stolen
ston'	stone
stone-bow	stonebow
stone-cutter	stonecutter
stonished	astonished
stony-hearted	stonyhearted
stopp'd	stopped
stopt	stopped
straight-forward	straightforward
straitfor'ard	straightforward
strappin'	strapping
strenly	sternly
strew'st	strewest
strict'st	strictest
striketh	strikes
strikin'	striking
stringin'	stringing
stript	stripped
strivin'	striving
strokedst	strokedest
strong'st	strongest
strornary	extraordinary
strown	strewn
struck'st	struckest
stubbs	stubs
stumbleth	stumbles
stumpin	stumping
stun'sails	stun-sails
suall	shall
sub-Sub-Librarian	sub-sub-librarian
subsistance	subsistence
subtile	subtle
subtilties	subtleties
subtilty	subtlety
succor	succour
such-like	suchlike
suck'st	suckest
suckin'	sucking
sudn't	shouldn't
sueing	suing
suerly	surely
sueth	sues
suffer'st	sufferest
sufferin'	suffering
sufficeth	suffices
suffocate	suffocated
sugar-candy	sugarcandy
suggesteth	suggests
suites	suits
sulkin'	sulking
summat	somewhat
summonsizzing	summonsing
summut	somewhat
sun-like	sunlike
sun-rise	sunrise
sun-set	sunset'
sunsett	sunset
super-serviceable	superserviceable
supplyant	suppliant
supplyment	supplement
supposin	supposing
suppresseth	suppresses
sure-ly	surely
surpasseth	surpasses
surprize	surprise
surprized	surprised
surprizes	surprises
surprizing	surprising
suspecteth	suspects
suthin	something
suthin'	something
swag-bellied	swagbellied
swallar	swallow
swallering	swallowing
swallers	swallows
swarin'	swearing
swarths	swaths
swath'd	swathed
swathling	swaddling
sway'st	swayest
swear'st	swearest
swearin'	swearing
sweaten	sweated
sweet'st	sweetest
swell'd	swelled
swell'st	swellest
swelleth	swells
swep	swept
swet	sweat
swine-herds	swineherds
swoln	swollen
sword-Fish	sword-fish
swound	swoon
swounded	swooned
swuir	swore
symptims	symptoms
syne	since
t'bargin	bargain
t'boards	boards
t'day	today
t'do	do
t'father	father
t'fowld	twofold
t'gallant	topgallant
t'gallant-mast	top-gallant-mast
t'gallant-sails	top-gallant-sails
t'kitchen	kitchen
t'lads	lads
t'maister	master
t'maister's	master's
t'other	other
t'othered	other
t'others	others
t'road	road
t'sowl	soul
t'will	it'll
tOM'S	Tom's
ta'	to
ta'en	taken
taan	taken
table-Rock	table-rock
tabourines	tabourins
taen	taken
tag-rag	tagrag
tahitan	Tahitan
tak	taken
tak'	take
tak'st	takest
take-a	take
taketh	takes
takin'	taking
talk'st	talkest
talkin	talking
talkin'	talking
tall-Spout	tall-spout
tallin'	talling
tan't	'tisn't
tap-house	taphouse
tarin'	tearing
tarr'd	tarred
tasselled	tasseled
tastin'	tasting
tat's	that's
tattering	tottering
taught'st	taughtest
tauld	told
taxt	taxed
taykettles	teakettles
teacheth	teaches
tear-stained	tearstained
tearin'	tearing
teazed	teased
teazin'	teazing
teazing	teasing
tek	take
tell'd	told
tell'st	tellest
tell-a	tell
tell-tale	telltale
tell-tales	telltales
tellin	telling
tellin'	telling
telt	told
temperality	temporality
tempteth	tempts
tender'st	tenderest
tendin'	tending
tenour	tenor
ter	to
terrestial	terrestrial
teter	teeter
tevil	devil
th	that
th'	the
th'Hall	th'hall
tha	that
thar	there
thar's	there's
thay	they
the'	they
the-atricals	theatricals
thear	there
thee't	thou'rt
theh	the
their'n	theirs
their's	theirs
theirseln	themselves
theirselves	themselves
theirsens	themselves
thenee	thence
ther's	there's
therby	thereby
thereabout	thereabouts
therefor	therefore
they'ld	they'd
they's	there's
thick-headed	thickheaded
thick-skin	thickskin
thickenin'	thickening
thief-stol'n	thief-stolen
think'st	thinkest
thinkin	thinking
thinkin'	thinking
thinkst	thinkest
thir	their
third-borough	thirdborough
this'	this's
tho'	though
thof	though
thoft	thought
thoght	thought
thorn-bush	thornbush
thou'ldst	thou'dst
thou't	thou'lt
thought'st	thoughtest
thoughts'	thoughts
thowt	thought
thrang	thronged
threatenin'	threatening
threepences	threepence
threepiled	three-piled
threfore	therefore
threw'st	threwest
thriveth	thrives
thro'	through
throughfares	thoroughfares
throughly	thoroughly
thrusteth	thrusts
thump'd	thumped
thunder'st	thunderest
thunder-batter'd	thunder-battered
thunder-claps	thunderclaps
thunder-stone	thunderstone
thunder-stroke	thunderstroke
thurst	thirst
thysel	thyself
thysen	thyself
tic-Dolly-row	tic-dolly-row
tick-tack	ticktack
tidyed	tidied
til	till
tilly-fally	tillyvally
tilt-yard	tiltyard
tinselled	tinseled
tip-toe	tiptoe
tipplin'	tippling
tir'd	tired
tirin'	tiring
tis	it's
tisick	phthisic
tithe-pig's	tithe's
title-page	titlepage
tke	the
to'	to
to-day	today
to-morrow	tomorrow
to-morrow's	tomorrow's
to-morrows	tomorrows
to-night	tonight
toder	tother
toge	toga
togither	together
toimes	times
toke	took
tol'able	tolerable
tolable	tolerable
told'st	toldest
tongeus	tongues
took'st	tookest
tooth-drawer	toothdrawer
top-gallant	topgallant
topfull	topful
torment'st	tormentest
tormenteth	torments
tosseth	tosses
tossin'	tossing
touch-stone	touchstone
toucheth	touches
tould	told
toun	town
tow'rds	towards
tow'rt	toward
toward	towards
towart	toward
towelling	toweling
tower-hill	towerhill
town-Hall	town-hall
town-Ho	town-ho
trackin'	tracking
trail'st	trailest
tramp'd	tramped
tranquility	tranquillity
trapesin'	trapesing
travaileth	travails
travelled	traveled
travellest	travelest
travelling	traveling
tread'st	treadest
treambled	trembled
treatin'	treating
tremlbing	trembling
trempling	trembling
tript	tripped
triumphery	triumvirate
troat	throat
trompet	trumpet
troth-plight	trothplighted
troublin	troubling
troups	troops
trow'st	trowest
trowsers	trousers
true-bred	truebred
true-hearted	truehearted
true-love	truelove
trustin'	trusting
try-Works	try-works
tryin	trying
tryin'	trying
tuh	to
tuk	took
tull	till
tum'le	tumble
tumblin'	tumbling
tung	tongue
tuold	told
turkies	turkeys
turn'st	turnest
turneth	turns
turnin'	turning
turrer	tother
tushes	tusks
tvice	twice
twelvemont'	twelvemonths'
twit	twitted
two-fold	twofold
twopences	twopence
tye	tie
ud	would
udge	judge
udnertakes	undertakes
ugh!	ugh
ull	will
un's	one's
unaisy	uneasy
unaneled	unannealed
unawars	unawares
unbecomin'	unbecoming
unbegot	unbegotten
unbiassed	unbiased
unco	uncommon
unconstrain'd	unconstrained
under-Secretary	under-secretary
under-bred	underbred
under-foot	underfoot
under-rated	underrated
under-selling	underselling
understan'	understand
understand'st	understandest
understandeth	understands
underta'en	undertaken
underteks	undertakes
undervallying	undervaluing
underwrit	underwit
unequalled	unequaled
unfoldeth	unfolds
unfort'nate	unfortunate
unfort'nt	unfortunate
unfortnet	unfortunate
unhook	unhooked
unkenn'd	unkenned
unnat'ral	unnatural
unpleasant'st	unpleasantest
unprovokes	unprovoked
unravelling	unraveling
unreconciliable	unreconcilable
unremoveable	unremovable
unremoveably	unremovably
unripedst	unrippedest
uns	ones
unspoke	unspoken
untempering	untempered
untill	until
up'ards	upwards
up-cast	upcast
up-roused	uproused
up-spring	upspring
up-staris	upstairs
upheaveth	upheaves
upholdeth	upholds
upo'	upon
upom	upon
upwards	upward
urgeth	urges
useth	uses
usin	using
usin'	using
usurp'd	usurped
usurp'st	usurpest
ut'	that
ut's	that's
uther	other
uttereth	utters
v'y'ge	voyage
valeyable	valuable
vally	valley
valor	valour
vanisheth	vanishes
vara	very
varld	world
varrah	very
varry	very
varsal	universal
vat	what
vaward	vanguard
ve	have
ve-ry	very
vell	well
ventur'	venture
ventur'd	ventured
ver	for
vestry-Boards	vestry-boards
vetch	fetch
vexeth	vexes
vexin'	vexing
vherefore	wherefore
victualled	victualed
victualling	victualing
viddout	without
vieweth	views
vill	will
villanies	villainies
villanous	villainous
villany	villainy
violenteth	violents
virginalling	virginaling
vlouting-stog	vlouting-stock
voeiferated	vociferated
volk	folk
vorld	world
vortnight	fortnight
voutsafe	vouchsafe
vow'd	vowed
vowedst	vowedest
vry	very
vun	fun
vurther	further
w'	with
w'ed	we'd
w-r-retches	wretches
wa'	wall
wa's	walls
wa-ter-Fall	waterfall
wadna	wouldn't
waft	wafted
wah	why
waiscoats	waistcoats
waiteth	waits
waitin'	waiting
wakin'	waking
wal	well
wald	walled
walk'st	walkest
walkin'	walking
wall'd	walled
wan	won
wan't	wasn't
wander'st	wanderest
wandereth	wanders
wanned	waned
want'st	wantest
want-wit	wantwit
wanteth	wants
wantin'	wanting
war'nt	weren't
war-Office	war-office
war-man	warman
ware-a	ware
warld	world
warn't	weren't
warna	weren't
warnt	weren't
warr'd	warred
warr'st	warrest
warranteth	warrants
was'n	wasn't
was'nt	wasn't
washin	washing
washin'	washing
wasna	wasn't
wast	waste
wat	that
watch-'ords	watchwords
watchin'	watching
water-colours	watercolours
water-fly	waterfly
water-work	waterwork
waur	worse
waverley-Castle	Waverley-Castle
waverley-Chase	Waverley-Chase
waverley-Hall	Waverley-Hall
waw'nt	wasn't
wax-Work	wax-work
waxeth	waxes
way-laid	waylaid
we'ld	we'd
we'n	we've
weak-hearted	weakhearted
weakspur'ted	weak-spirited
wear'st	wearest
wear-a	wear
weareth	wears
weather-beaten	weatherbeaten
wecould	could
wed'st	weddest
wedder	whether
weddin'	wedding
weel	well
weel-fa'rd	well-fared
weel-far'd	welfared
weep'st	weepest
weepons	weapons
weigh'st	weighest
weil	well
weld	wielded
well!	well
well-a-day	welladay
well-apparelled	well-appareled
well-born	wellborn
well-bred	wellbred
well-doing	welldoing
well-known	wellknown
well-took	well-taken
welliday	welladay
went'st	wentest
wepping	weapon
wer	were
werena	weren't
wern't	weren't
wexed	waxed
wezand	weazand
wha	who
wha's	who's
whale-Bones	whale-bones
whale-Fishery	whale-fishery
whale-Watch	whale-watch
whale-e	whale
whalin'	whaling
whar	where
wharfs	wharves
whase	whose
what!	what
what-ye-call't	what-you-call-it
whate'er	whatever
whativer	whatever
whatsoe'er	whatsoever
whatsome'er	whatsoever
whatten	what
whe'er	whether
whear	where
whenColonel	whencolonel
whencesoe'er	whencesoever
whene'er	whenever
where'er	wherever
where-with	wherewith
wheres	where
wheresoe'er	wheresoever
wheresome'er	wheresoever
whet'st	whettest
whetteth	whets
whiles	while
whilome	whilom
whilst	while
whip'd	whipped
whipp'st	whippest
whippin'	whipping
whirl'd	whirled
whirlpooles	whirlpools
white-Foot	white-foot
white-Hart	white-hart
who-e	who
who-ee	who
whoe'er	whoever
whoiver	whoever
whome	whom
whoo	who
whoo-bub	who-bub
whosoe'er	whosoever
whosomever	whosoever
whups	whips
wi	with
wi'	with
wi'bein'	wi'being
wi'out	without
wi't	with't
wice	vice
wicked'st	wickedest
wid	with
widg	with
widout	without
wife-like	wifelike
wihtout	without
wild-cat	wildcat
wild-fowl	wildfowl
wild-goose	wildgoose
willains	villains
willeth	wills
willin	willing
willin'	willing
willing'st	willingest'
willut	will
winder	window
winders	windows
windring	windering
wink'st	winkest
winna	won't
winter-time	wintertime
wintry	wintery
wiolinceller	violoncello
wiolincellers	violoncellos
wish'd	wished
wish't	wished
wisheth	wishes
wisht	wished
wisitin	visiting
wisiting	visiting
wisitors	visitors
wist	wisted
withereth	withers
witnesseth	witnesses
wo	woe
wo't	wilt
wod	would
woefull'st	woefullest
woful	woeful
wofully	woefully
womenkind	womankind
wonderfull	wonderful
wonn	won
wonna	won't
wonst	once
woo't	wilt
wood-birds	woodbirds
woodbind	woodbine
woodhouse-ing	woodhousing
wool-sack	woolsack
wooman	woman
woonder	wonder
work'st	workest
worketh	works
worki'day	workaday
workin'	working
worky-day	workday
worm-eaten	wormeaten
worn't	weren't
worreted	worrited
worritin'	worriting
worser	worse
worts	words
wos	was
wot'st	wottedest
wotna	won't
wou'd	would
would'nt	wouldn't
would'st	wouldst
wouldest	wouldst
wouldna	wouldn't
wound'st	woundest
wounldn't	wouldn't
wrapt	wrapped
wretched'st	wretchedest
writin	writing
writin'	writing
wrong'd	wronged
wrong'st	wrongest
wull	will
wunna	won't
wunst	once
wur	were
wus	worse
wuss	worse
wuth	worth
wutna	won't
y'	you
y'ull	you'll
y-ravished	ravished
ya'as'dy	yesterday
yah	you
yah'll	you'll
yah're	you're
yallow	yellow
yankee-Land	yankee-land
yclad	clad
ycleped	cleped
ye'd	you'd
ye'll	you'll
ye'n	you've
ye'r	you're
ye're	you're
ye've	you've
ye-es	yes
yeas	yea
yeat	eat
yeaur	your
yees	yes
yer's	here's
yer-rings	ear-rings
yere	year
yerself	yourself
yerseln	yourself
yerselves	yourselves
yes'day	yesterday
yesday	yesterday
yest	yeast
yinder	yonder
yis	yes
yit	yet
yo	you
yo'	you
yo'd	you'd
yo'll	you'll
yo'r	your
yo're	you're
yo've	you've
yoke-fellow	yokefellow
yoketh	yokes
yon	yond
yong	young
you'ld	you'd
you'n	you've
you'r	you're
younder	yonder
young'st	youngest
your's	yours
yoursebls	yourselves
yourselin	yourself
yourseln	yourself
yoursen	yourself
youself	yourself
yoy're	you're
yslaked	slaked
yóur	your
zed	z
zermons	sermons
zest	zestest
zir	sir
zo	so
zwaggered	swaggered
g*d	god
G*d	God
d*mn	damn
D*mn	Damn
youv'e	you've
twas	'twas
hav	have
ov	of
y'r	you
mor'n	more-than
quicker'n	quicker-than
you'se	you're
youse	you
'Andley-Cross	Handley-Cross
'Ighness	Highness
'Olloway	Holloway
'Oward	Howard
'She	She
'Tention	Attention
'ack hack
'ackney hackney
'air-dresser hair-dresser
'alf half
'alf-a-crown half-a-crown
'alf-crown half-crown
'alf-hour half-hour
'alfcrown halfcrown
'alfpenny halfpenny
'alfpound halfpound
'and hand
'and-in-'and hand-in-hand
'andicap handicap
'andicapper handicapper
'andkerchief handkerchief
'andle handle
'ands hands
'appiness happiness
'ard hard
'ard-money hard-money
'ardly hardly
'ardship hardship
'armony harmony
'arness harness
'arpy harpy
'arshness harshness
'ay hay
'ay-and-corn hay-and-corn
'bacca-box tobacco-box
'bility ability
'bomination abomination
'cademy academy
'commodation acommodation
'complice acomplice
'conomy economy
'cos because
'ead head
'eard heard
'earers hearers
'eart-rendin heart-rending
'edge-row hedge-row
'eiress heiress
'elp help
'ermit	hermit
'esitation	hesitation
'hogany mahogany
'lection election
'lotment allotment
'mergency	emergency
'molument	emolument
'noculation innoculation
'nuity annuity
'oax	hoax
'obby hobby
'olesale wholesale
'oliday holiday
'ome home
'ome-stall home-stall
'omeliness homeliness
'onour honour
'ooman woman
'ope hope
'orror horror
'orse horse
'orseback horseback
'orses horses
'orsewhip horsewhip
'orspital hospital
'ospitality hospitality
'oss-back horse-back
'osses horses
'ossman horseman
'ossmanship horsemanship
'otel hotel
'ound hound
'ounds hounds
'ouse house
'ouse-work house-work
'ousehold household
'ousekeeper housekeeper
'ousekeeping housekeeping
'ousemaid housemaid
'ow how
'pediment impediment
'plomacy diplomacy
'pology apology
'poplexy apoplexy
'pothecary apothecary
'prenticeship apprenticeship
'quaintance aquaintance
'rection erection
'rethmetic arithmetic
'ristocrat aristocrat
'rithmetic arithmetic
'sociation association
'sparagus asparagus
'spectability respectability
'squire esquire
'sylum asylum
'tachment attachment
'tain't tain't
'umbug humbug
'umility humility
'unger hunger
'unt hunt
'unter hunter
'untin' hunting
'unting hunting
'unting-field hunting-field
'unting-wicket hunting-wicket
'untsman huntsman
'urt hurt
'usband husband
'vantage advantage
'vertisement advertisement
Anythin'	Anything
Athley'th	Athley'th
B'leeve	Believe
B'low-Bridge	B'low-Bridge
Ba'spiel	Ba'spiel
Balmaha'	Balmaha'
Ca'stalk	Ca'stalk
Ch'am-maid	Chambermaid
EM'LY	EMILY
Edinbroo'	Edinborough
Em'ly	Emily
Farrin'don	Farringdon
George's-st	George's-st
Giles-o'-lanthorn	Giles-o'-lanthorn
Glo'ster	Glo'ster
Haribee-broo'	Haribee-broo'
Hows'ever	Howsoever
Jeames's-square	James's-square
Joth'phine	Jothphine
La'ship	Ladyship
Leaden'all	Leaden'all
Lon'on	London
M‘Drone	M'Drone
Ma'amselle	Mademoiselle
Mas'r	Master
Mich'lmas	Michaelmas
Wal'r	Walter
Went'orth	Wentworth
Wor'ster	Worcester
a'thegither	altogether
awfu'	awful
bloomin'	blooming
cap'n	captain
doan't	don't
doen't	don't
dursn't	daren't
fearfu'	fearful
flow'rs	flowers
gen'lemen	gentlemen
gen'lm'n	gentleman
gi'e	give
ha'n't	haven't
hav'n't	haven't
havin'	having
i'stead	instead
mak'	make
mis'ess	mistress
shillin'	shilling
somethin'	something
standin'	standing
t'ou	thou
thro'	through
vouldn't	wouldn't
waitin'	waiting
yo'r	your
yoursel'	yourself